教えて!!魔法のlyric	オシエテ:マホーノリリック
教えて!!魔法のLyric	オシエテ:マホーノリリック
教えて!!魔法のLYRIC	オシエテ:マホーノリリック
.com	ドットコム
.net	ドットネット
(N)INE	ナイン
美@nca	ビアンカ
/m	マイメートル
/m3	マイリッポーメートル
1000th	サウザンス
100th	ハンドレッス
10th	テンス
11th	イレブンス
12th	トゥエルフス
13th	サーティーンス
14th	フォーティーンス
15th	フィフティーンス
16mm	ジューロクミリ
16th	シックスティーンス
17th	セブンティーンス
18th	エイティーンス
19th	ナインティーンス
1st	ファースト
1st place	ファーストプレイス
1st Place	ファーストプレイス
1st PLACE	ファーストプレイス
1stplace	ファーストプレイス
1stPlace	ファーストプレイス
1stPLACE	ファーストプレイス
20th	トゥエンティース
2nd	セカンド
302A	サンマル:ニエー
306A	サンマル:ロクエー
30th	サーティース
3D	スリーディー
3DO	スリーディーオー
3M	スリーエム
3rd	サード
402A	ヨンマル:ニエー
40th	フォーティース
4th	フォース
4WD	ヨンダブリューディー
50th	フィフティース
5th	フィフス
60th	シックスティース
6th	シックスス
70th	セブンティース
76ers	セブンティーシクサーズ
7th	セブンス
80th	エイティース
8th	エイス
90th	ナインティース
9th	ナインス
a	アール
A	アンペア
A.D.	エーディー
A.F.O.K	エーエフオーケー
A.M.	エーエム
A.P.C	エーピーシー
A/m	アンペアマイメートル
エアバスA300	エアバスエイサンビャク
A5	エイゴ
AA	エーエー
AAA	エーエーエー
AAAI	トリプルエーアイ
Aaron	アーロン
AB	エイビー
ABADA	アバダ
ABC	エイビーシー
ABCD	エービーシーディー
ABCP	エービーシーピー
AbemaTV	アベマティービー
ABEND	アーベント
ability	アビリティー
ABM	エービーエム
ABO	エービーオー
about	アバウト
ABR	エービーアール
AbS	エービーエス
ABS	エービーエス
Abstract	アブストラクト
ABSTRIPS	アブストリプス
abuse	アビューズ
ABWR	エービーダブリューアール
ABX	エービーエックス
ABZORB	アブゾーブ
ac	エーシー
AC	エーシー
academic	アカデミック
Academic	アカデミック
Academy	アカデミー
ACAP	エーシーエーピー
ACAS	エーシーエーエス
acceptor	アクセプター
Access	アクセス
ACCESS	アクセス
account	アカウント
Account	アカウント
ACD	エーシーディー
ACDE	エーシーディーイー
ACE	エーシーイー
ACGME	エーシージーエムイー
ACL	エーシーエル
ACLU	エーシーエルユー
ACML	エーシーエムエル
ACN	エーシーエヌ
ACOUSTIC	アコースティック
ACR	エーシーアール
Acrobat	アクロバット
ACRS	エーシーアールエス
ACS	エーシーエス
ACSA	エーシーエスエー
ACSC	エーシーエスシー
ACSR	エーシーエスアール
ACSS	エーシーエスエス
ACSTD	エーシーエスティーディー
Act	アクト
ACT	アクト
ACTFL	エーシーティーエフエル
action	アクション
Action	アクション
ACTION	アクション
active	アクティブ
Active	アクティブ
ACTPN	エーシーティーピーエヌ
AD	エイディー
ADA	エーディーエー
ADB	エーディービー
Adbe	アドビ
ADC	エーディーシー
address	アドレス
Address	アドレス
ADEOS	アデオス
ADESS	エーディーイーエスエス
ADF	エーディーエフ
ADHD	エイディーエイチディー
ADI	エーディーアイ
adidas	アディダス
ADL	エーディーエル
administration	アドミニストレーション
Administration	アドミニストレーション
Administrator	アドミニストレーター
Admission	アドミッション
ADMIX	エーディーエムアイエックス
Adobe	アドビ
ADP	エーディーピー
ADPC	エーディーピーシー
ADPCM	エーディーピーシーエム
ADR	エーディーアール
ADSL	エーディーエスエル
advantage	アドバンテージ
Adventures	アドベンチャーズ
ADVICE	アドバイス
AE	エーイー
AEC	エーイーシー
AED	エーイーディー
AEGIS	イージス
AEIS	エーイーアイエス
Aeolus	アイオロス
AEON	イオン
AERO	エアロ
Aerospace	エアロスペース
Aether	イーサー
af	エーエフ
AF	エーエフ
AFA	エイエフエイ
AFC	エイエフシー
AfDB	エーエフディービー
AfDF	エーエフディーエフ
Affaires	アフェアーズ
Affairs	アフェアーズ
AFFO	エーエフエフオー
AFLACスクェア	アフラックスクェア
AFP	エイエフピー
AFQT	エーエフキューティー
AFRIKA	アフリカ
AFTA	エイエフティーエイ
AFTAX	エーエフティーエーエックス
after	アフター
After	アフター
Afternoon	アフタヌーン
Ag	エージー
AG	エージー
again	アゲイン
against	アゲンスト
AGC	エージーシー
age	エージ
Age	エージ
Agency	エージェンシー
AGENCY	エージェンシー
Agenda	アジェンダ
AGENDA	アジェンダ
Agent	エージェント
AGFI	エージーエフアイ
AGNS	エージーエヌエス
AGP	エージーピー
Agreement	アグリーメント
AGRIS	エージーアールアイエス
AGROKEY	エージーアールオーケーイーワイ
AHA	エイエイチエイ
AHP	エイエイチピー
AHS	エイエイチエス
AHSRA	エイエイチエスアールエイ
AI	エーアイ
AIBD	エーアイビーディー
AIBO	アイボ
AIC	エーアイシー
AICON	エーアイシーオーエヌ
AIDE	エイド
AIDS	エイズ
AIDXT	エーアイディーエックスティー
AIEC	エーアイイーシー
AIF	エーアイエフ
AIFF	エーアイエフエフ
AIG	エイアイジー
AIHO	アイホー
AII	エーアイアイ
aiko	アイコ
AIM	エーアイエム
Air	エアー
AIR	エアー
Airborne	エアボーン
AIRS	エーアイアールエス
AIS	エーアイエス
AISIN	アイシン
AIST	エーアイエスティー
AIT	エーアイティー
AJCCEP	エージェーシーシーイーピー
AJINOMOTO	アジノモト
AKARI	アカリ
AKIBA	アキバ
akiko	アキコ
Akio	アキオ
AKTUR	エーケーティーユーアール
Al	エーエル
AL	エーエル
Ala	エーエルエー
ALA	エーエルエー
ALAP	エーエルエーピー
ALARA	エーエルエーアールエー
ALB	エーエルビー
ALBUM	アルバム
Alc	エーエルシー
ALCATOR	エーエルシーエーティーオーアール
ALCM	エーエルシーエム
Alcon	アルコン
ALERT	アラート
Alessandro	アレッサンドロ
ALESSIAL	アレッシー
Alexei	アレクセイ
ALGOL	アルゴル
Alignment	アラインメント
Alison	アリソン
all	オール
All	オール
ALL	オール
Allen	アレン
aloha	アロハ
alone	アローン
ALOS	エーエルオーエス
ALS	エーエルエス
ALSCAL	エーエルスカル
Alt	エーエルティー
ALT	エーエルティー
Alternative	オルターナティブ
always	オールウェーズ
ALWAYS	オールウェーズ
am	アム
AM	エーエム
amano	アマノ
amazon	アマゾン
Amazon	アマゾン
AMB	エーエムビー
AMD	エーエムディー
AMeDAS	アメダス
AMEDAS	アメダス
Amen	アーメン
America	アメリカ
AMERICA	アメリカ
American	アメリカン
AMES	エーエムイーエス
AMEX	アメックス
AMF	エイエムエフ
AMG	エーエムジー
AMICA	アミカ
AMOS	エーモス
AMP	アンプ
ams西武	アムスセーブ
AMS	エーエムエス
AMZ	エーエムズィー
an	アン
An	アン
ANA	エイエヌエイ
Analytic	アナリティック
Analyzer	アナライザー
ANC	エイエヌシー
and	アンド
AND	アンド
ANDANTE	アンダンテ
Andover	アンドーバー
ANDRA	エーエヌディーアールエー
Andrew	アンドリュー
android	アンドロイド
Android	アンドロイド
ANDROID	アンドロイド
Angel	エンジェル
animal	アニマル
ANIMAL	アニマル
ANIMATION	アニメーション
Anne	アン
Annex	アネックス
ANNEX	アネックス
Annihilation	アニヒレーション
ANNIVASARY	アニバーサリー
ANNIVERSARY	アニバーサリー
Anniverssary	アニバーサリー
Annual	アニュアル
ANOVA	アノーバ
ANRPC	エーエヌアールピーシー
ANSI	アンシー
ANSUS	エーエヌエスユーエス
answer	アンサー
Antenna	アンテナ
Anti	アンチ
Antonio	アントニオ
ANVAR	エーエヌブイエーアール
ANZUS	アンザス
AO	エーオー
AOC	エーオーシー
AOD	エーオーディー
AOL	エーオーエル
AOTS	エーオーティーエス
AOYAMA	アオヤマ
AP	エイピー
Apache	アパッチ
APAN	エーピーエーエヌ
APEC	エイペック
APEX	エーピーイーエックス
APGA	エーピージーエー
APGAR	アプガー
API	エーピーアイ
APICNET	エイピーアイシーエヌイーティー
APII	エーピーアイアイ
APIO	アピオ
APIS	エーピーアイエス
APL	エーピーエル
APLAC	エイピーエルエイシー
Apm	エーピーエム
APM	エーピーエム
APN	エーピーエヌ
APO	エーピーオー
APP	エーピーピー
Appendix	アペンディックス
apple	アップル
Apple	アップル
Application	アプリケーション
approach	アプローチ
Approach	アプローチ
APPTC	エーピーピーティーシー
APPU	エーピーピーユー
April	エープリル
APRSAF	エーピーアールエスエーエフ
APS	エーピーエス
APSG	エーピーエスジー
APT	エーピーティー
aq	エーキュー
AQ	エーキュー
AQUARIUS	アクエリアス
Aquinas	アキナス
AQUOS	アクオス
Ar	エーアール
AR	エーアール
ARB	エーアールビー
ARC	エイアールシー
Archaeology	アーキオロジー
architect’s	アーキテクツ
ARCO	エイアールシーオー
ARE	アー
area	エリア
Area	エリア
AREA	エリア
ARENA	エーアールイーエヌエー
ARF	エーアールエフ
ARG	アーグ
ARGO	エーアールジーオー
Aria	アリア
ARIES	アリエス
Aristoteles	アリストテレス
Arm	アーム
ARMA	アルマ
Army	アーミー
Arnold	アーノルド
Arnot	アーノット
around	アラウンド
ARPA	エーアールピーエー
Arrangement	アレンジメント
arrows	アローズ
ARROWS	アローズ
ARSR	エーアールエスアール
art	アート
Art	アート
ART	アート
ARTEMIS	アルテミス
Arthur	アーサー
article	アーティクル
Artist	アーチスト
Artiza	アルチザ
Arts	アーツ
ARTS	エーアールティーエス
ARX	エーアールエックス
as	アズ
AS	エーエス
ASA	エイエスエイ
ASAHI	アサヒ
ASAT	エーサット
ASATO	アサト
ASCA	エーエスシーエー
ASCII	アスキー
ASCO	エーエスシーオー
ASCOT	エーエスシーオーティー
ASD	エーエスディー
ASEAN	アセアン
ASEM	エーエスイーエム
ASEP	エーエスイーピー
ASFA	エーエスエフエー
ashira	アシーラ
Asia	アジア
Asian	アジアン
ASIC	エーエスアイシー
ASICS	アシックス
ASIMO	アシモ
ASJ	エーエスジェー
ASL	エーエスエル
ASM	エーエスエム
ASME	アスメ
Asmik	アスミック
ASO	エーエスオー
ASP	エイエスピー
ASPAC	アスパック
Aspartyl	アスパルチル
aspect	アスペクト
ASR	エーエスアール
ASROC	アスロック
Asse	エーエスエスイー
assent	アセント
assessment	アセスメント
Assessment	アセスメント
ASSET	エーエスエスイーティー
assets	アセッツ
Assets	アセッツ
Associate	アソシエート
Associates	アソシエイツ
association	アソシエーション
Association	アソシエーション
assumption	アサンプション
AST	エーエスティー
ASTA	アスタ
ASTEC	アステック
ASTEM	アステム
ASTI	アスティ
ASTINFO	エーエスティーアイエヌエフオー
ASTRO	アストロ
ASUS	エイスース
ASV	エーエスブイ
ASYMSCAL	エーシンムスケール
at	アット
At	エーティー
AT	エイティー
AT&T	エイティーアンドティー
ATA	エーティーエー
ATC	エイティーシー
ATG	エーティージー
Athlon	アスロン
ATI	エーティーアイ
ATIS	エーティス
ATL	エーティーエル
ATLANTIS	アトランティス
atm	アトム
ATM	エイティーエム
ATN	エーティーエヌ
ATO	エイティーオー
ATOK	エートック
Atomic	アトミック
ATOMIC	アトミック
ATP	エーティーピー
ATR	エイティーアール
ATRAC	アトラック
ATRD	エーティーアールディー
ATS	エイティーエス
ATSUHI	アツシ
ATT	エーティーティー
attention	アテンション
Attention	アテンション
ATTENTION	アテンション
ATV	エイティーブイ
ATX	エーティーエックス
au	エーユー
Au	エーユー
AU	エーユー
AUC	エーユーシー
audio	オーディオ
Auditor	オーディター
Audrey	オードリー
Auguste	オーギュスト
Augustinus	アウグスティヌス
AURO	アウロ
Australia	オーストラリア
author	オーサー
Author	オーサー
authority	オーソリティー
Authority	オーソリティー
Auto	オート
AUTO	オート
autumn	オータム
Autumn	オータム
AUTUMN	オータム
AV	エイブイ
avatar	アバター
average	アベレージ
avex	エイベックス
AVF	エイブイエフ
AVI	エーブイアイ
AVLIS	エーブイエルアイエス
AVM	エーブイエム
AVR	エーブイアール
AWACS	エイダブリューエイシーエス
AWC	エーダブリューシー
AWK	オーク
AWR	エーダブリューアール
AX	アックス
AXiS寿屋	アクシスコトブキヤ
AYANA	アヤナ
ayu	アユ
Ayumi	アユミ
AZ	エーゼット
AZT	エイゼットティー
Aztecs	アステカ
B助	ビースケ
B.C.	ビーシー
B/s	ビーピーエス
B4判	ビーヨンバン
B5	ビーゴ
Ba	ビーエー
BA	ビーエー
Baby	ベビー
Bachelor	バチェラー
Bachelor’s	バチェラーズ
back	バック
Back	バック
Bacon	ベーコン
BADGE	バッジ
BAe	ビーエイイー
bag	バッグ
BAG	バッグ
balance	バランス
Ball	ボール
BAN	ビーエーエヌ
bank	バンク
Bank	バンク
BANK	バンク
Bankers	バンカース
bar	バー
Bar	バー
BAR	ビーエイアール
Barling	バーリング
barometer	バロメーター
Barro	バロー
BASEBALL	ベースボール
BASF	バスフ
basic	ベーシック
Basic	ベーシック
BASIC	ベーシック
bay	ベイ
BAY	ベイ
BAYONET	バヨネット
BB	ビービー
BBBB	ビービービービー
BBC	ビービーシー
BBM	ビービーエム
BBQ	ビービーキュー
BBS	ビービーエス
BC	ビーシー
Bcc	ビーシーシー
BCC	ビーシーシー
BCG	ビーシージー
BCL	ビーシーエル
Bcr	ビーシーアール
BCRD	ビーシーアールディー
BCS	ビーシーエス
BD	ビーディー
be	ビー
Be	ビー
BE	ビー
BEAM	ビーム
Bean	ビーン
Beautiful	ビューティフル
Beauty	ビューティー
BEAUTY	ビューティー
because	ビコーズ
BECK	ベック
become	ビカム
BEE	ビー
Beeton	ビートン
Before	ビフォー
BEGIN	ビギン
Behind	ビハインド
belief	ビリーフ
BELIEVER	ビリーバー
Bell	ベル
Belshaw	ベルショー
Benjamin	ベンジャミン
Bergman	バーグマン
Berlin	ベルリン
best	ベスト
Best	ベスト
BETHSY	ビーイーティーエイチエスワイ
Betty	ベティー
BF	ビーエフ
BFH	ビーエフエイチ
BFM	ビーエフエム
BG	ビージー
BGM	ビージーエム
BH	ビーエイチ
BHC	ビーエイチシー
BHCN	ビーエイチシーエヌ
BHN	ビーエイチエヌ
BHP	ビーエイチピー
BI	ビーアイ
BIA	ビーアイエー
BIBRO	ビブロ
BIC	ビーアイシー
Bick	ビック
BIG	ビッグ
BIGLOBE	ビッグローブ
bill	ビル
Billings	ビリングズ
Billmore	ビルモア
BILOG	バイログ
Bin	ビーアイエヌ
BINAP	ビーアイエヌエーピー
Biography	バイオグラフィー
Biological	バイオロジカル
BIOS	バイオス
BIRD	バード
Biro	バイロー
BIS	ビーアイエス
Biscuit	ビスケット
B—ISDN	ビーアイエスディーエヌ
bit	ビット
BIT	ビーアイティー
Bitcoin	ビットコイン
BKP	ビーケーピー
BL	ビーエル
Black	ブラック
BLACK	ブラック
Blaster	ブラスター
BLE	ビーエルイー
BLITZ	ブリッツ
BLK	ビーエルケー
blog	ブログ
Blog	ブログ
BLOG	ブログ
Blood	ブラッド
blue	ブルー
Blue	ブルー
BLUE	ブルー
Blueprints	ブループリンツ
Bluetooth	ブルートゥース
Blu−ray	ブルーレイ
BM	ビーエム
BMA	ビーエムエー
BMBW	ビーエムビーダブリュー
BMDP	ビーエムディーピー
BMFT	ビーエムエフティー
BMG	ビーエムジー
BMI	ビーエムアイ
BMIR	ビーエムアイアール
BMP	ビーエムピー
BMVg	ビーエムブイジー
BMW	ビーエムダブリュー
BMWi	ビーエムダブリューアイ
BMWI	ビーエムダブリューアイ
BMX	ビーエムエックス
BN	ビーエヌ
BNFL	ビーエヌエフエル
BNL	ビーエヌエルー
BNP	ビーエヌピー
BoA	ボア
BOA	ビーオーエー
BOAC	ビーオーエーシー
BOD	ビーオーディー
body	ボディー
Body	ボディー
BODY	ボディー
bon	ボン
BOOCS	ブックス
book	ブック
Book	ブック
BOOK	ブック
BOP	ビーオーピー
BOR	ビーオーアール
BORN	ボーン
BORO BORO	ボロボロ
Bosh	ボシュ
BOSS	ボス
Boston	ボストン
Bosworth	ボスワース
BOT	ボット
BOURBON	バーボン
BOUTIQUE	ブティック
Bowlby	ボールビー
box	ボックス
Box	ボックス
BOX	ボックス
Boxer	ボクサー
BOY	ボーイ
Boys	ボーイズ
BOYS	ボーイズ
bp	ビーピー
BP	ビーピー
BPO	ビーピーオー
bps	ビーピーエス
Bps	ビーピーエス
Bq	ベクレル
br	ビーアール
Br	ビーアール
BR	ビーアール
BRAIN	ブレーン
Branch	ブランチ
BRAVIA	ブラビア
bread	ブレッド
break	ブレーク
Break	ブレーク
BREAK	ブレーク
BRI	ビーアールアイ
BRICs	ブリックス
bridge	ブリッジ
Brigg	ブリッグ
Britain	ブリテン
BRO	ビーアールオー
broadband	ブロードバンド
brother	ブラザー
Brown	ブラウン
BROWN	ブラウン
Bryan	ブライアン
BS	ビーエス
BS2	ビーエスニ
BSAT	ビーエスエーティー
BSC	ビーエスシー
BSD	ビーエスディー
BSE	ビーエスイー
BSS	ビーエスエス
BT	ビーティー
BTB	ビーティービー
BTR	ビーティーアール
BU	ビーユー
budget	バジェット
Budget	バジェット
building	ビルディング
Building	ビルディング
Bulletin	ブレティン
BUMP	バンプ
BUN	ビーユーエヌ
Bunka	ブンカ
Bunkamura	ブンカムラ
Bureau	ビューロー
Bureaucracy	ビューロクラシー
Buren	ビューレン
Burke	バーク
Burrows	バローズ
BUS	バス
Business	ビジネス
but	バット
But	バット
Butler	バトラー
butter	バター
BUZZ	バズ
BW	ビーダブリュー
BWC	ビーダブリューシー
BWR	ビーダブリューアール
BWV	ビーダブリューブイ
by	バイ
By	バイ
bye	バイ
byte	バイト
Byte	バイト
B’z	ビーズ
BZ	ビーズ
BZP	ビーゼットピー
°C	ド
C/kg	クーロンマイキログラム
C/mol	クーロンマイモル
C&WHKT	シーアンドダブリューエイチケーティー
C&WHKTI	シーアンドダブリューエイチケーティーアイ
c++	シープラスプラス
C++	シープラスプラス
Ca	シーエー
CA	シーエー
CAB	シーエービー
CABRI	カブリ
CAC	シーエーシー
CACM	シーエーシーエム
CAD	キャド
CADMEX	シーエーディーエムイーエックス
CAE	シーエーイー
cafe	カフェ
Cafe	カフェ
Cafin	カフィン
CAFTA	シーエーエフティーエー
CAIP	ケイプ
Cake	ケーキ
CAKE	ケーキ
cal	カロリー
CAL	シーエイエル
Calendar	カレンダー
California	カリフォルニア
CALIS	ケーリス
call	コール
Call	コール
Calle	カルレ
called	コールド
CALS	シーエイエルエス
CAM	シーエーエム
Cambridge	ケンブリッジ
Camera	カメラ
Camp	キャンプ
CAMS	シーエーエムエス
can	キャン
Can	キャン
Canada	カナダ
CanBe	キャンビー
CanCam	キャンキャン
Cancel	キャンセル
cancer	キャンサー
Cancer	キャンサー
CANCER	キャンサー
CANDU	シーエーエヌディーユー
Cangal	キャンギャル
Canon	キャノン
CANON	キャノン
CanoScan	キャノスキャン
Canvas	キャンバス
CAP	シーエーピー
CAPD	シーエーピーディー
CAPIC	キャピック
CAPISE	シーエーピーアイエスイー
capital	キャピタル
Capital	キャピタル
CAPOEIRA	カポエラ
CAPRICORN	カプリコーン
Caps	キャップス
CAPTAIN	キャプテン
Card	カード
CARD	カード
care	ケア
Career	キャリア
Caribbean	カリビアン
CARICOM	シーエイアールアイシーオーエム
CARIFTA	カリフタ
Carl	カール
CARLTON	カールトン
Carmine	カーマイン
Carnegie	カーネギー
carry	キャリー
Carson	カーソン
CART	カート
Cartain	カーテン
CAS	シーエーエス
CASCADE	カスケード
case	ケース
CASE	ケース
CASH	キャッシュ
castle	キャッスル
casual	カジュアル
CAT	シーエーティー
catch	キャッチ
CATDAP	キャットダップ
Category	カテゴリー
CATV	シーエイティーブイ
CAVE	ケイブ
CAY	カイ
CB	シービー
CBC	シービーシー
CBD	シービーディー
Cbi	シービーアイ
CBI	シービーアイ
CBL	シービーエル
CBO	シービーオー
CBS	シービーエス
cbv	シービーブイ
cc	シーシー
Cc	シーシー
CC	シーシー
CCD	シーシーディー
CCET	シーシーイーティー
CCGA	シーシージーエー
CCIR	シーシーアイアール
CCIS	シーシーアイエス
CCITT	シーシーアイティーティー
ccLTD	シーシーエルティーディー
CCP	シーシーピー
CCR	シーシーアール
CCRA	シーシーアールエー
CCTV	シーシーティーブイ
CCW	シーシーダブリュー
CD	シーディー
CDA	シーディーエー
CDB	シーディービー
CDC	シーディーシー
CDE	シーディーイー
CDFR	シーディーエフアール
CDI	シーディーアイ
CDIAC	シーディーアイエーシー
CDM	シーディーエム
CDMA	シーディーエムエー
cDNA	シーディーエヌエー
CDR	シーディーアール
CD—ROM	シーディーロム
CDS	シーディーエス
cdv	シーディーブイ
CE	シーイー
CEA	シーイーエー
ceatec	シーテック
Ceatec	シーテック
CEATEC	シーテック
ceatec japan	シーテックジャパン
Ceatec Japan	シーテックジャパン
CEATEC JAPAN	シーテックジャパン
CEF	シーイーエフ
CEFTA	シーイーエフティーエー
CEGB	シーイージービー
Celeron	セレロン
CELP	セルプ
center	センター
Center	センター
CENTO	シーイーエヌティーオー
Central	セントラル
Central Coast	セントラルコースト
Centre	センター
CEO	シーイーオー
CEOS	シーイーオーエス
CEPA	シーイーピーエー
CEPT	シーイーピーティー
CER	シーイーアール
Cerebrum	セレブラム
CERN	セルン
Certificate	サーティフィケート
CES	シーイーエス
cevio	チェビオ
Cevio	チェビオ
CeVIO	チェビオ
CEVIO	チェビオ
Cf	シーエフ
CF	シーエフ
cf.	シーエフ
CFA	シーエフエー
CFC	シーエフシー
CFD	シーエフディー
CFFM	シーエフエフエム
CFG	シーエフジー
CFTC	シーエフティーシー
CG	シージー
CGA	シージーエー
CGB	シージービー
CGC	シージーシー
CGI	シージーアイ
CGIAR	シージーアイエーアール
CGS単位	シージーエスタンイ
ch	シーエイチ
CH	シーエイチ
CH4	シーエイチフォー
Cha−Cha−Cha	チャチャチャ
CHAID	チェード
Chain	チェーン
chair	チェア
champignon	シャンピニョン
Championship	チャンピオンシップ
CHAMPIONSHIP	チャンピオンシップ
change	チェンジ
Change	チェンジ
Changes	チェンジズ
Chapter	チャプター
CHAPTER	チャプター
Chara	チャラ
CHARA	チャラ
character	キャラクター
Character	キャラクター
Charivari	シャリバリ
Charles	チャールズ
Charlotte	シャーロット
Chart	チャート
Chat	チャット
CHAT	チャット
CHATR	チャター
CHDF	シーエイチディーエフ
check	チェック
Check	チェック
CHECK	チェック
cheese	チーズ
Chef	シェフ
Chemical	ケミカル
CHEMISTRY	ケミストリー
Chicago	シカゴ
Chichen	チチェン
CHICKEN	チキン
Chief	チーフ
child	チャイルド
Child	チャイルド
CHILD	チャイルド
children	チルドレン
Children	チルドレン
CHILDS	チャイルズ
Chimaira	キマイラ
Chimera	キメラ
china	チャイナ
China	チャイナ
CHINCOM	チンコム
Chine	シーヌ
Chinese	チャイニーズ
CHIYODA	チヨダ
CHIYUKI	チユキ
Chlorine	クローリン
CHMM	シーエイチエムエム
Choi	チョイ
Choice	チョイス
CHOKKA	チョッカ
Chonchocoro	チョンチョコロ
CHOP	シーエイチオーピー
CHOYA	チョーヤ
Christian	クリスチャン
Christmas	クリスマス
CHRISTMAS	クリスマス
Chrome	クローム
Chromecast	クロームキャスト
CHUNK	チャンク
Church	チャーチ
μCi	マイクロキュリー
CI	シーアイ
CIA	シーアイエイ
CIAIR	シーアイエアー
CIAO	シーアイエーオー
CIAT	シーアイエーティー
CIC	シーアイシー
CICCP	シーアイシーシーピー
CIE	シーアイイー
CIEC	シーアイイーシー
CIELITO	シエリト
cif	シーアイエフ
CIF	シーアイエフ
CIFRE	シーアイエフアールイー
CIM	シム
CIME	シーアイエムイー
CINEMA	シネマ
CIO	シーアイオー
CIP	シーアイピー
Circuit	サーキット
CIRST	シーアイアールエスティー
CIS	シーアイエス
CISC	シスク
Cisco	シスコ
CISPR	シーアイエスピーアール
CITES	シーアイティーイーエス
Citizen′s	シチズンズ
city	シティー
City	シティー
CITY	シティー
CIW	シーアイダブリュー
CIWS	シーアイダブリューエス
CJTF	シージェイティーエフ
CK	シーケイ
CKD	シーケイディー
CKY	シーケーワイ
cl	シーエル
Cl	シーエル
CL	シーエル
CLAIR	シーエルエーアイアール
Classic	クラシック
Claude	クロード
Claudia	クラウディア
CLE	シーエルイー
clean	クリーン
clear	クリア
CLEAR	クリア
Clearing	クリーニング
Click	クリック
client	クライアント
Climate	クライメート
Clinical	クリニカル
Clip	クリップ
CLIP	クリップ
CLIR	シーエルアイアール
Clistea	クリスティア
CLK	シーエルケー
CLO	シーエルオー
close	クローズ
CLP	シーエルピー
CLS	シーエルエス
Club	クラブ
CLUB	クラブ
CLV	シーエルブイ
cm	センチメートル
CM	シーエム
cm/秒	センチメートルマイビョー
cm2	ヘーホーセンチメートル
cm3	リッポーセンチメートル
CMA	シーエムエー
CMAAO	シーエムエーエーオー
Cmax	シーエムエーエックス
CMC	シーエムシー
CME	シーエムイー
CMF	シーエムエフ
CMIT	シーエムアイティー
日本CMK	ニホンシシィーエムケー
CMN	シーエムエヌ
CMOS	シーモス
CMS	シーエムエス
CMU	シーエムユー
CMw	シーエムダブリュー
CMW	シーエムダブリュー
CNE	シーエヌイー
CNER	シーエヌイーアール
CNES	シーエヌイーエス
C—NET	シーネット
CNF	シーエヌエフ
CNG	シーエヌジー
CNN	シーエヌエヌ
CNRA	シーエヌアールエー
CNRS	シーエヌアールエス
CNRT	シーエヌアールティー
co	シーオー
Co	シーオー
CO	シーオー
CO2	シーオーツー
CoA	シーオーエー
COACH	コーチ
COB	シーオービー
COBE	シーオービーイー
COBOL	コボル
CoCo	ココ
COCOM	ココム
COD	シーオーディー
Code	コード
Codec	コーデック
CODEVTEL	シーオーディーイーブイティーイーエル
COE	シーオーイー
coeur	クール
coffee	コーヒー
Coffee	コーヒー
COFFEE	コーヒー
COGEMA	シーオージーイーエムエー
Cohen	コーエン
cold	コールド
Coleman	コールマン
Coleridge	コールリッジ
Collaborative	コラボレーティブ
Collateralized	コラテライズド
Collection	コレクション
COLLECTION	コレクション
College	カレッジ
Collins	コリンズ
Color	カラー
column	コラム
Column	コラム
COLUMN	コラム
com	コム
come	カム
Come	カム
COMECON	コメコン
comedy	コメディー
COMETS	シーオーエムイーティーエス
coming	カミング
COML	コムル
Comment	コメント
COMMENT	コメント
comments	コメンツ
Commercial	コマーシャル
commission	コミッション
Commission	コミッション
Committee	コミッティー
communication	コミュニケーション
Communication	コミュニケーション
communications	コミュニケーションズ
community	コミュニティー
Community	コミュニティー
COMP	シーオーエムピー
COMPACT	シーオーエムピーエーシーティー
company	カンパニー
Company	カンパニー
Competency	コンピテンシー
competition	コンペティション
Competition	コンペティション
complex	コンプレックス
complexity	コンプレキシティー
component	コンポーネント
Comprehensive	コンプリヘンシブ
Com‐pression	コンプレッション
Computer	コンピューター
computing	コンピューティング
COMSAT	コムサット
CON	コン
CONCERT	コンサート
condictio	コンディクティオ
condition	コンディション
Condition	コンディション
Condliffe	コンドリフ
Condorcet	コンドルセ
Conduct	コンダクト
Conference	コンファレンス
Congress	コングレス
Congressional	コングレッショナル
CONMEBOL	コンメボル
consumer	コンシューマー
Consumer	コンシューマー
Container	コンテナ
Content	コンテント
Contents	コンテンツ
context	コンテキスト
Context	コンテキスト
Continue	コンティニュー
Contract	コントラクト
Contractor	コントラクター
Control	コントロール
Controller	コントローラー
Controls	コントロールズ
CONTURA	コンチュラ
CONTURA AERO	コンチュラエアロ
Convention	コンベンション
Conventional	コンベンショナル
CONVERSE	コンバース
Conyers	コニャーズ
COO	シーオーオー
Coo Doo’s	クードゥーズ
Cooking	クッキング
COOKING	クッキング
cool	クール
COOL	クール
COOP	コープ
Cooperation	コーペレーション
COORDCOM	シーオーオーアールディーシーオーエム
Coordinating	コーディネーティング
coordination	コーディネーション
COP	シーオーピー
COPA	シーオーピーエー
COPD	シーオーピーディー
copen	コペン
COPUOS	シーオーピーユーオーエス
Copyright	コピーライト
CoQ	シーオーキュー
CORBA	コルバ
Core	コア
Cornell	コーネル
Corot	コロー
Corporation	コーポレーション
Correct	コレクト
CORTECH	シーオーアールティーイーシーエイチ
cos	コサイン
COS	シーオーエス
COSMETS	コスメッツ
COSMOS	コスモス
COSPAR	シーオーエスピーエーアール
COTAL	シーオーティーエーエル
Council	カウンシル
Country	カントリー
course	コース
Course	コース
COURSE	コース
Court	コート
COW	シーオーダブリュー
cox	シーオーエックス
Cox’s	コックスズ
CP	シーピー
CPA	シーピーエー
CPAP	シーピーエーピー
CPF	シーピーエフ
CPI	シーピーアイ
CPK	シーピーケー
CPR	シーピーアール
CPS	シーピーエス
CPT	シーピーティー
CPU	シーピーユー
Cr	シーアール
CR	シーアール
CRBR	シーアールビーアール
CRC	シーアールシー
CRD	シーアールディー
CRDP	シーアールディーピー
Cream	クリーム
create	クリエート
creative	クリエイティブ
Creative	クリエイティブ
CREATIVE	クリエイティブ
CREATOR	クリエイター
CREATOR’S	クリエーターズ
CRED	シーアールイーディー
Credit	クレジット
CREST	クレスト
Crime	クライム
Critical	クリティカル
CRL	シーアールエル
cross	クロス
CROSS	クロス
CRP	シーアールピー
CRPPH	シーアールピーピーエイチ
CRS	シーアールエス
CRT	シーアールティー
crypton	クリプトン
Crypton	クリプトン
CRYPTON	クリプトン
crystal	クリスタル
Cs	シーエス
CS	シーエス
CSCE	シーエスシーイー
CSCL	シーエスシーエル
CSCW	シーエスシーダブリュー
CSD	シーエスディー
CSF	シーエスエフ
CSIS	シーエスアイエス
CSJ	シーエスジェー
CSK	シーエスケイ
CSL	シーエスエル
CSME	シーエスエムイー
CSN	シーエスエヌ
CSNI	シーエスエヌアイ
CSP	シーエスピー
C—SPAN	シースパン
CSPS	シーエスピーエス
CSR	シーエスアール
CSRT	シーエスアールティー
CSS	シーエスエス
CST	シーエスティー
CSTP	シーエスティーピー
CT	シーティー
CTB	シーティービー
CTBT	シーティービーティー
CTBTO	シーティービーティーオー
CTC	シーティーシー
CTD	シーティーディー
CTI	シーティーアイ
CTIA	シーティーアイエー
Ctrl	シーティーアールエル
Cu	シーユー
CU	シーユー
CUBE	キューブ
cubit	キュビット
CUI	シーユーアイ
Cultural	カルチュラル
culture	カルチャー
CUP	カップ
currency	カレンシー
current	カレント
Current	カレント
Curtin	カーティン
curve	カーブ
Custom	カスタム
°C−ute	キュート
CV	シーブイ
CVCC	シーブイシーシー
CVR	シーブイアール
CVS	シーブイエス
CVT	シーブイティー
CW	シーダブリュー
CWC	シーダブリューシー
CX	シーエックス
CYBER	サイバー
cycle	サイクル
CYCLE	サイクル
Cyclone	サイクロン
Cygames	サイゲームス
D子	ディーコ
ワシントンD.C.	ワシントンディーシー
D.I.	ディーアイ
D.W.B.	ディーダブリュービー
D&C	ディーアンドシー
DA	ディーエー
DAC	ディーエーシー
DAD	ディーエーディー
DAF	ダフ
DAG	ディーエージー
DAISY	デイジー
dam	デカメートル
DAM	ダム
Danger	デンジャー
DAPHNE	ダフネ
Dark	ダーク
DARPA	ダーパ
DAT	ダット
data	データ
Data	データ
DATA	データ
date	デート
DATE	デイト
David	デビッド
DAVID	デビッド
Davidson	デビッドソン
DAX	ディーエーエックス
day	デー
Day	デー
DAY	デー
days	デイズ
Days	デイズ
DAYS	デイズ
db	ディービー
dB	デシベル
DB	ディービー
dBA	ディービーエー
DBエクスポートDRYビール	ディービーエクスポートドライビール
DBM	ディービーエム
DBML	ディービーエムエル
DBMS	ディービーエムエス
DBRDM	ディービーアールディーエム
DBS	ディービーエス
DC	ディーシー
DCG	ディーシージー
DCM	ディーシーエム
DCNA	ディーシーエヌエー
DCR	ディーシーアール
DCSG	ディーシーエスジー
DD	ディーディー
DDC	ディーディーシー
DDI	ディーディーアイ
DDL	ディーディーエル
DDR	ディーディーアール
DDT	ディーディーティー
DDX	ディーディーエックス
de	デ
DE	デ
DEA	ディーイーエー
dead	デッド
Dead	デッド
dear	ディアー
Dear	ディアー
death	デス
Death	デス
DEATH	デス
Debate	ディベート
Debt	デット
DEC	ディーイーシー
December	ディセンバー
dechirer	デシレ
decision	ディシジョン
DECODE	デコード
Decrypter	ディクリプター
DEEN	ディーン
deep	ディープ
Deep	ディープ
DEF	デフ
default	デフォルト
DEFAULT	デフォルト
Defence	ディフェンス
Defense	ディフェンス
DEFF	デフ
degree	ディグリー
Degree	ディグリー
del	デル
delete	デリート
Delete	デリート
Delivery	デリバリー
DELL	デル
demarche	デイマーシュ
Democracy	デモクラシー
Democratic	デモクラティック
DEMOS	デモス
DeNA	ディーエヌエー
DENON	デノン
DEP	デプ
der	デア
Der	デア
DER	デル
De‐rivative	デリバティブ
DeSeO	デセオ
Design	デザイン
DESIGN	デザイン
Designer	デザイナー
DESIGNS	デザインズ
desire	デザイアー
Desire	ディザイアー
desk	デスク
detail	ディテール
Detection	ディテクション
Detroit	デトロイト
Deutsche	ドイチェ
development	デベロップメント
Development	ディベロップメント
device	デバイス
Devil	デビル
Dewey	デューイ
DEX	ディーイーエックス
DF	ディーエフ
DF31	ディーエフサンイチ
DF41	ディーエフヨンイチ
DFA	ディーエフエー
DFDR	ディーエフディーアール
DfE	ディーエフイー
DFE	ディーエフイー
DFG	ディーエフジー
DFR	ディーエフアール
DFT	ディーエフティー
DFX	ディーエフエックス
DH	ディーエイチ
DHA	ディーエイチエイ
DHCP	ディーエイチシーピー
DHL	ディーエイチエル
DHT	ディーエイチティー
DI	ディーアイ
DIA	ディーアイエイ
dial	ダイヤル
DIALOG	ダイアローグ
DIALS	ダイアルス
Diamond	ダイヤモンド
DIAMOND	ダイヤモンド
Diary	ダイアリー
DIC	ディク
Dictionary	ディクショナリー
DID	ディーアイディー
DIDO	ダイド
die	ダイ
Diego	ディエゴ
DIG	ディーアイジー
digest	ダイジェスト
Digestive	ダイジェスティブ
DigiOn	デジオン
digital	デジタル
DIGITAL	デジタル
DIGITS	ディジット
ding‐dong	ディンドン
DINKS	ディンクス
dinner	ディナー
DION	ディオン
DIOR	ディオール
DIP	ディップ
DIPS	ディーアイピーエス
Direct	ダイレクト
DirecTV	ディレクティービー
DiRR	ディーアイアールアール
dirty	ダーティー
DIS	ディーアイエス
Disability	ディスアビリティー
Disaster	ディザスター
discussion	ディスカッション
Disk	ディスク
Disney	ディズニー
DISNEY	ディズニー
Display	ディスプレー
DisplayPort	ディスプレイポート
distribution	ディストリビューション
Dive	ダイブ
DIVER	ダイバー
Division	ディビジョン
DIY	ディーアイワイ
DJ	ディージェイ
DK	ディーケイ
dl	デシリットル
dL	デシリットル
DL	ディーエル
DLC	ディーエルシー
DLJ	ディーエルジェー
DLL	ディーエルエル
DLT	ディーエルティー
dm	デシメートル
DM	ディーエム
DMCE	ディーエムシーイー
DME	ディーエムイー
DMS	ディーエムエス
DMZ	ディーエムゼット
DNA	ディーエヌエイ
DNF	ディーエヌエフ
DNMES	ディーエヌエムイーエス
DNP	ディーエヌピー
DNS	ディーエヌエス
do	ドゥー
Do	ドゥー
DO	ディーオー
DOB	ドブ
docomo	ドコモ
Docomo	ドコモ
DoCoMo	ドコモ
DOCOMO	ドコモ
doctor	ドクター
Document	ドキュメント
Documents	ドキュメンツ
DOE	ディーオーイー
DOHC	ディーオーエイチシー
Dolby	ドルビー
Dolls	ドールズ
Dolly	ドリー
domain	ドメイン
Domain	ドメイン
domestic	ドメスティック
Domestic	ドメスティック
DOMESTIC	ドメスティック
Don	ドン
Donald	ドナルド
DonDoko	ドンドコ
Don’t	ドント
DON’T	ドント
DOOM	ドゥーム
DOP	ディーオーピー
Doppelzimmer	ドッペルツィンメル
DOPS	ディーオーピーエス
DOS	ドス
DOT	ディーオーティー
double	ダブル
Double	ダブル
Douwes	ダウエス
down	ダウン
DP	ディーピー
DPC	ディーピーシー
DPE	ディーピーイー
dpi	ディーピーアイ
DQN	ドキュン
Dr	ドクター
DR	ディーアール
Dr.	ドクター
Dragon	ドラゴン
DRAGON	ドラゴン
DRAM	ディーラム
dream	ドリーム
DREAM	ドリーム
Dreams	ドリームス
DRESS	ドレス
DRG	ディーアールジー
DRI	ディーアールアイ
drive	ドライブ
Drive	ドライブ
DRIVE	ドライブ
Driver	ドライバー
DRIVER	ドライバー
DRM	ディーアールエム
drop	ドロップ
DROP	ドロップ
DRP	ディーアールピー
DRT	ディーアールティー
DRTS	ディーアールティーエス
DRY	ドライ
ds	ディーエス
DS	ディーエス
DSB	ディーエスビー
DSD	ディーエスディー
DshK	ドシュカ
DSI	ディーエスアイ
DSIU	デシュー
DSL	ディーエスエル
DSM	ディーエスエム
DSO	ディーエスオー
DSP	ディーエスピー
DSRC	ディーエスアールシー
DST	ディーエスティー
DSTI	ディーエスティーアイ
DT	ディーティー
DTA	ディーティーエー
DTAX	ディーティーエーエックス
DTD	ディーティーディー
DTP	ディーティーピー
DTSG	ディーティーエスジー
DU	ディーユー
Duc	ドゥック
Duncan	ダンカン
Durable	デュラブル
dust	ダスト
Dutch	ダッチ
DUTY	デューティー
DV	ディーブイ
dvd	ディーブイディー
DVD	ディーブイディー
DVI	ディーブイアイ
DW	ディーダブリュー
DWB	ディーダブリュービー
DWK	ディーダブリューケー
DX	ディーエックス
Dynabook	ダイナブック
DynaBook	ダイナブック
dynamic	ダイナミック
Dzibilchaltun	ジビルチャルトゥン
はぴe	ハピイー
E郎	イーロー
E.T.	イーティー
E/N	イーエヌ
EA	イーエー
EAI	イーエーアイ
early	アーリー
Early	アーリー
earth	アース
Earth	アース
East	イースト
EAST	イースト
eastern	イースタン
Eastern	イースタン
EASTERN	イースタン
eat	イート
EATA	イーエーティーエー
EBM	イービーエム
EBR	イービーアール
EBRD	イービーアールディー
EC	イーシー
ECAFE	エカフェ
ECAT	イーシーエーティー
ECB	イーシービー
ECCS	イーシーシーエス
ECE	イーシーイー
ECHELON	エシュロン
ECLA	イーシーエルエー
ECM	イーシーエム
eco	エコ
ECO	エコ
Ecology	エコロジー
ecomo	エコモ
economic	エコノミック
Economic	エコノミック
economy	エコノミー
Economy	エコノミー
ECOWAS	エコワス
ECPAT	エクパット
ECS	イーシーエス
ECSC	イーシーエスシー
ECSS	イーシーエスエス
ECU	イーシーユー
ED	イーディー
EDCF	イーディーシーエフ
EDF	イーディーエフ
EDI	イーディーアイ
EDICT	イーディクト
Edition	エディション
Editor	エディター
EDL	イーディーエル
EDMC	イーディーエムシー
EDR	イーディーアール
EDRC	イーディーアールシー
EDS	イーディーエス
EDTV	イーディーティーブイ
Education	エデュケーション
EDVAC	エドバック
Edy	エディ
EE	イーイー
EEA	イーイーエイ
EEC	イーイーシー
EECS	イーイーシーエス
EEG	イーイージー
EEP	イーイーピー
EER	イーイーアール
EES	イーイーエス
EEZ	イーイーゼット
EF	イーエフ
EFASID	エフェーシッド
Effect	エフェクト
efficiency	エフィシェンシー
EFL	イーエフエル
EFTA	エフタ
EG	イージー
EGC	イージーシー
egg	エッグ
EGG	イージージー
ego	エゴ
EGR	イージーアール
Egress	エングレス
EHF	イーエイチエフ
EIAJ	イーアイエイジェイ
EIE	イーアイイー
EIGHT	エイト
Einstein	アインシュタイン
Einzelzimmer	アインツェルツィンメル
Eisuke	エイスケ
EITF	イーアイティーエフ
EIU	イーアイユー
EIW	イーアイダブリュー
EJ	イージェー
EK	イーケー
El Tajin	エルタヒン
elder	エルダー
ELEC	エレック
Electric	エレクトリック
electron	エレクトロン
Electronic	エレクトロニック
Electronics	エレクトロニクス
element	エレメント
Elements	エレメンツ
Elevation	エレベーション
ELISA	エライザ
Elizabeth	エリザベス
ELRA	エルラ
Else	エルス
EM	イーエム
Emacs	イーマックス
EMBO	エンボ
EMCS	イーエムシーエス
EMG	イーエムジー
EMI	イーエムアイ
Emile	エミール
emime	イーマイム
Emime	イーマイム
EMIME	イーマイム
EMMA	エマ
Employment	エンプロイメント
EMPTY	エンプティー
EMS	イーエムエス
EMU	イーエムユー
ENA	エナ
End	エンド
ENDO	エンドー
energy	エネルギー
Energy	エネルギー
engine	エンジン
Engineers	エンジニアズ
English	イングリッシュ
ENIAC	エニアック
ENIX	エニックス
Enjoy	エンジョイ
Enkianthus	エンキアンサス
ENSR	イーエヌエスアール
Enter	エンター
ENTER	エンター
Enterprise	エンタープライズ
Entity	エンティティー
entry	エントリー
Enumeration	エニュメレーション
ENV	イーエヌブイ
environment	エンバイロメント
Environment	エンバイロメント
Environmental	エンバイロメンタル
EOS	イーオーエス
EP	イーピー
EPA	イーピーエー
EPC	イーピーシー
EPD	イーピーディー
EPI	イーピーアイ
EPIC	イーピーアイシー
EPIRB	イーピーアイアールビー
episode	エピソード
EPMA	イーピーエムエー
EPN	イーピーエヌ
EPO	エポ
EPOC	イーピーオーシー
EPOS	イーピーオーエス
EPR	イーピーアール
EPS	イーピーエス
EPSON	エプソン
EPSP	イーピーエスピー
EPSS	イーピーエスエス
EPST	イーピーエスティー
EQ	イーキュー
EQS	イーキューエス
equity	エクイティー
Equity	エクイティー
ER	イーアール
ERASMUS	エラスムス
ERB	イーアールビー
ERDA	イーアールディーエー
ERI	イーアールアイ
Erich	エーリヒ
ERiO	エリオ
ERLt	イーアールエルティー
ERM	イーアールエム
ERP	イーアールピー
ES	イーエス
ESA	イーサ
ESAC	イーエスエーシー
ESCAP	エスカップ
ESCAPE	エスケープ
ESCO	イーエスシーオー
ESDP	イーエスディーピー
ESK	イーエスケー
ESL	イーエスエル
ESP	イーエスピー
ESPN	イーエスピーエヌ
ESPRIT	エスプリ
ESPS	イーエスピーエス
ESRO	イーエスアールオー
ESS	イーエスエス
Essential	エッセンシャル
ESTA	エスタ
ESV	イーエスブイ
ET	イーティー
ETA	イーティーエー
etc	エトセトラ
ETC	イーティーシー
ETF	イーティーエフ
Ethernet	イーサネット
ethyl	エチル
etiopurpurin	エチオプルプリン
ETOS	イーティーオーエス
ETPS	イーティーピーエス
ETS	イーティーエス
ETSI	イーティーエスアイ
Eu	イーユー
EU	イーユー
EUC	イーユーシー
Eugenia	ユージニア
EUN	イーユーエヌ
EURATOM	ユーラトム
EUREKA	ユーレカ
Europe	ヨーロッパ
European	ヨーロピアン
EUROVISION	ユーロビジョン
EV	イーブイ
evaluation	エバリューション
EVE	イブ
Evening	イブニング
event	イベント
Event	イベント
ever	エバー
EVER	エバー
every	エブリー
Every	エブリー
evidence	エビデンス
EVIL	エビル
毎日EVRシステム	マイニチイーブイアールシステム
Νewトップ	ニュートップ
EX	イーエックス
example	エグザンプル
Excel	エクセル
Excellent	エクセレント
Exchange	エクスチェンジ
Executive	エグゼクティブ
EXILE	エグザイル
Exit	エグジット
EXP	イーエックスピー
experience	エクスペリエンス
Exploit	エクスプロイト
Exploration	エクスプロレーション
explorer	エクスプローラー
Explorer	エクスプローラー
Expo	エキスポ
EXPO	エキスポ
EXPO70	エキスポナナジュー
exponent	エクスポーネント
export	エクスポート
Export	エクスポート
express	エクスプレス
Express	エクスプレス
EXPRESS	エクスプレス
expression	エクスプレッション
Extender	エクステンダー
eye	アイ
EYE	アイ
Eyer	アイヤー
Eyes	アイズ
EZ	イーゼット
EZLN	イーゼットエルエヌ
F	エフ
F.R.P	エフアールピー
F.R.P.	エフアールピー
F1	エフワン
F15	エフジューゴ
F3000	エフサンゼン
F4	エフヨン
FA	エフエイ
FAA	エフエーエー
Fable	フェーブル
face	フェース
Face	フェース
FACE	フェイス
Facebook	フェイスブック
Facet	ファセット
FaceTime	フェイスタイム
Factor	ファクター
Faculty	ファカルティー
fallout	フォールアウト
FALSE	フォールス
Famiポート	ファミポート
family	ファミリー
Family	ファミリー
fan	ファン
Fan	ファン
FAN	ファン
FANTASIA	ファンタジア
FANTASY	ファンタジー
FAO	エフエイオー
FAOSTAT	エフエーオーエスティーエーティー
FAQ	ファッキュ
FAR	エフエーアール
farida’s	ファリダス
fas	エフエーエス
FAS	エフエーエス
Fast	ファースト
FAT	エフエーティー
Fate	フェイト
father	ファーザー
Father	ファーザー
Favorite	フェーバリット
Fax	ファックス
FAX	ファックス
Fax.	ファックス
FAZ	エフエイゼット
FB	エフビー
FBI	エフビーアイ
FBR	エフビーアール
FBTR	エフビーティーアール
Fc	エフシー
FC	エフシー
FCC	エフシーシー
FCEV	エフシーイーブイ
FCP	エフシーピー
FCS	エフシーエス
FD	エフディー
FDA	エフディーエイ
FDM	エフディーエム
FDMA	エフディーエムエー
FDP	エフディーピー
FDR	エフディーアール
FDTD	エフディーティーディー
FDTE	エフディーティーイー
Fe	エフイー
FE	エフイー
FEAL	フィール
FEALAC	エフイーエーエルエーシー
FEATHERED	フェザード
February	フェブラリー
FEC	エフイーシー
FED	エフイーディー
Federal	フェデラル
FedEx	フェデックス
FEDEX	フェデックス
feel	フィール
feeling	フィーリング
feet	フィート
FellowShip	フェローシップ
FEMA	エフイーエムエー
FEN	エフイーエヌ
fence	フェンス
Fengshen	フンシェン
FEOF	エフイーオーエフ
FEOGA	エフイーオージーエー
Ferenc	フェレンツ
fes	フェス
festival	フェスティバル
Festival	フェスティバル
FESTIVAL	フェスティバル
Festivals	フェスティバルス
FF	エフエフ
FFA	エフエフエー
FFBP	エフエフビーピー
FFO	エフエフオー
FFP	エフエフピー
FFRDC	エフエフアールディーシー
FFT	エフエフティー
FFTE	エフエフティーイー
FFTF	エフエフティーエフ
FG	エフジー
FGGE	エフジージーイー
FGMDSS	エフジーエムディーエスエス
FH	エフエイチ
FhG	エフエイチジー
FHJ	エフエイチジェー
FIA	エフアイエイ
FIC	エフアイシー
FIDO	エフアイディーオー
FIFA	フィファ
figma	フィグマ
Figure	フィギュア
file	ファイル
File	ファイル
FILE	ファイル
Film	フィルム
FILM	フィルム
FINA	エフアイエヌエー
final	ファイナル
FiNAL	ファイナル
FINAL	ファイナル
FINAL FANTASY	ファイナルファンタジー
Finance	ファイナンス
financial	ファイナンシャル
Financial	ファイナンシャル
Finder	ファインダー
Fine	ファイン
FINE	ファイン
FINGER	フィンガー
FIR	エフアイアール
Fire	ファイア
FIRE	ファイア
Firefox	ファイアフォックス
Firewall	ファイアーウォール
First	ファースト
FIS	エフアイエス
FISH	フィッシュ
Fisher	フィッシャー
Fishstat	エフアイエスエイチエスティーエイティー
FIT	エフアイティー
FIVB	エフアイブイビー
Five	ファイブ
FIVE	ファイブ
fixed	フィックスト
Fixed	フィックスト
FIZ	エフアイゼット
FK	エフケイ
FLAGS	フラッグス
Flarion	フラリオン
FLASH	フラッシュ
Fleming	フレミング
flite	フライト
Flite	フライト
FLITE	フライト
flite+hts engine	フライトプラス:エイチティーエスエンジン
Flite+hts engine	フライトプラス:エイチティーエスエンジン
Flite+Hts Engine	フライトプラス:エイチティーエスエンジン
FLITE+HTS ENGINE	フライトプラス:エイチティーエスエンジン
flite+hts_engine	フライトプラス:エイチティーエスエンジン
Flite+hts_engine	フライトプラス:エイチティーエスエンジン
Flite+Hts_Engine	フライトプラス:エイチティーエスエンジン
FLITE+HTS_ENGINE	フライトプラス:エイチティーエスエンジン
flite+htsengine	フライトプラス:エイチティーエスエンジン
Flite+htsengine	フライトプラス:エイチティーエスエンジン
Flite+HtsEngine	フライトプラス:エイチティーエスエンジン
FLITE+HTSENGINE	フライトプラス:エイチティーエスエンジン
FLN	エフエルエヌ
FLNC	エフエルエヌシー
FLOPS	フロップス
flow	フロー
FLOWER	フラワー
flowers	フラワーズ
Fly	フライ
fm	エフエム
FM	エフエム
FMC	エフエムシー
FMLN	エフエムエルエヌ
FMPT	エフエムピーティー
FMS	エフエムエス
FMU	エフエムユー
FMV	エフエムブイ
Fn	エフエヌ
FNEC	エフエヌイーシー
FNLA	エフエヌエルエー
FNN	エフエヌエヌ
FNNR	エフエヌエヌアール
FNS	エフエヌエス
fob	エフオービー
FOB	エフオービー
FOCUS	フォーカス
Fodor	フォーダー
foF	エフオーエフ
FOFA	エフオーエフエー
FOIL	フォイル
Folder	フォルダー
FOMA	フォーマ
FOMC	エフオーエムシー
font	フォント
Font	フォント
Fontainebleau	フォンテンブロー
food	フード
Food	フード
FOOT	フット
FOOTBALL	フットボール
for	フォー
FOR	フォー
Force	フォース
Fore	フォー
Foreign	フォーリン
Forest	フォレスト
forever	フォーエバー
Forever	フォーエバー
formula	フォーミュラ
FORTRAN	フォートラン
Forum	フォーラム
forward	フォワード
FOS	エフオーエス
Foucault	フーコー
fOUL	ファウル
Four	フォー
FOUR	フォー
Fourier	フーリエ
FOURIN	エフオーユーアールアイエヌ
FOV	エフオーブイ
FOX	フォックス
foxy	フォクシー
FP	エフピー
FPLMTS	エフピーエルエムティーエス
fps	エフピーエス
Fr	エフアール
FR	エフアール
frame	フレーム
Frame	フレーム
Framework	フレームワーク
France	フランス
Frank	フランク
Franz	フランツ
FRB	エフアールビー
Fred	フレッド
free	フリー
Free	フリー
FREE	フリー
French	フレンチ
Frequency	フリークエンシー
fresh	フレッシュ
Friday	フライデー
Friedman	フリードマン
friend	フレンド
Friend	フレンド
FRIEND	フレンド
Friend’s	フレンズ
FRIENDS	フレンズ
from	フロム
From	フロム
FROM	フロム
Frost	フロスト
FRP	エフアールピー
FRR	エフアールアール
FS	エフエス
FT	エフティー
FTA	エフティーエー
FTAA	エフティーエイエイ
FTb	エフティービー
FTC	エフティーシー
FTN	エフティーエヌ
ftp	エフティーピー
FTP	エフティーピー
FTTH	エフティーティーエイチ
FU	エフユー
Fuck	ファック
FUGITIVE	フュージティブ
Fuji	フジ
full	フル
Fumiko	フミコ
FUN	ファン
function	ファンクション
functional	ファンクショナル
Fund	ファンド
FUNE	フネ
funnel	ファンネル
fusion	フュージョン
future	フューチャー
FW	エフダブリュー
FWA	エフダブリューエー
FX	エフエックス
g	グラム
G	ギガ
g/cm3	グラムマイリッポーセンチメートル
g/m3	グラムマイリッポーメートル
G1	ジーワン
G10	ジーテン
G2	ジーツー
G7	ジーセブン
G7プラス1	ジーセブンプラスワン
GA	ジーエー
GAAA	ジーエーエーエー
GaAsFET	ジーエーエーエスエフイーティー
GABA	ギャバ
GAC	ジーエイシー
Gackt	ガクト
galatea	ガラテア
Galatea	ガラテア
GALATEA	ガラテア
Galaxy	ギャラクシー
Gallery	ギャラリー
GALLERY	ギャラリー
GAM	ジーエーエム
GAMA	ガマ
GAME	ゲーム
GAO	ガオ
GAP	ギャップ
garden	ガーデン
Garden	ガーデン
Gardner	ガードナー
GARP	ジーエーアールピー
gas	ガス
GATE	ゲート
GATS	ジーエーティーエス
GATT	ガット
GAUBATZ	ガーバッツ
GAW	ジーエーダブリュー
Gb	ギガバイト
GB	ギガバイト
GB/s	ギガビーピーエス
GBI	ジービーアイ
Gbit	ギガビット
GBL	ジービーエル
Gbps	ギガビーピーエス
GBps	ギガビーピーエス
GC	ジーシー
gcc	ジーシーシー
GCC	ジーシーシー
GCP	ジーシーピー
GCR	ジーシーアール
GCRA	ジーシーアールエー
GDA	ジーディーエー
GDB	ジーディービー
GDBM	ジーディービーエム
GDE	ジーディーイー
GDIN	ジーディーアイエヌ
GDP	ジーディーピー
GDPGAP	ジーディーピージーエーピー
Ge	ジーイー
GE	ジーイー
Gears	ギヤズ
GEC	ジーイーシー
GeForce	ジーフォース
Gemini	ジェミニ
GEMINI	ジェミニ
GEMS	ジェムズ
GEN	ジェン
gender	ジェンダー
General	ゼネラル
Generalisation	ジェネラリゼイション
GENEVA	ジュネーブ
光GENJI	ヒカルゲンジ
gentium	ジェンティウム
Geography	ジオグラフィー
George	ジョージ
GEOTAIL	ジオテイル
GERMANY	ジャーマニー
gesellschaft	ゲゼルシャフト
Gesellschaft	ゲゼルシャフト
get	ゲット
Get	ゲット
GET	ゲット
GETSCO	ジーイーティーエスシーオー
GFE	ジーエフイー
GFI	ジーエフアイ
GFS	ジーエフエス
GHC	ジーエイチシー
GHIBLI	ジブリ
GHQ	ジーエイチキュー
GHz	ギガヘルツ
GHZ	ギガヘルツ
GI	ジーアイ
GIA	ジーアイエイ
GIANTS	ジャイアンツ
Gibbons	ギボンズ
Gibson	ギブソン
gif	ジーアイエフ
GIF	ジフ
Gigabit	ギガビット
GIGABYTE	ギガバイト
Giglio	ジリオ
GII	ジーアイアイ
Gilbert	ギルバート
GIP	ジーアイピー
GIPSCAL	ジップスケール
Girl	ガール
Girls	ガールズ
GIS	ジーアイエス
GIT	ジーアイティー
give	ギブ
GK	ジーケイ
GKN	ジーケーエヌ
GKS	ジーケーエス
GLAPS	グラプス
GLAY	グレイ
GLCM	ジーエルシーエム
GLE	ジーエルイー
GLiB	ジーリブ
glide	グライド
glider	グライダー
Gln	ジーエルエヌ
global	グローバル
Global	グローバル
GLOBE	グローブ
GLP	ジーエルピー
GLR	ジーエルアール
GM	ジーエム
GMAT	ジーマット
GMB	ジーエムビー
GmbH	ジーエムビーエイチ
GMBH	ジーエムビーエイチ
GMDSS	ジーエムディーエスエス
GMM	ジーエムエム
GMML	ジーエムエムエル
GMP	ジーエムピー
GMS	ジーエムエス
GMSS	ジーエムエスエス
GMT	ジーエムティー
GMTV	ジーエムティーブイ
GN	ジーエヌ
GN(D)P	ジーエヌディーピー
GNE	ジーエヌイー
GNI	ジーエヌアイ
GNN	ジーエヌエヌ
GNOME	ジーエヌオーエムイー
GNP	ジーエヌピー
GNU	ジーエヌユー
go	ゴー
Go	ゴー
GO	ゴー
God	ゴッド
GOD	ゴッド
GODZILLA	ゴジラ
Goffman	ゴッフマン
going	ゴーイング
Going	ゴーイング
GOL	ゴル
GOLD	ゴールド
Golden	ゴールデン
GOLDWYN	ゴールドウィン
GOLF	ゴルフ
GOLiB	ジーオーリブ
good	グッド
Good	グッド
GOOD	グッド
Goods	グッズ
Google	グーグル
GOOS	ジーオーオーエス
GOOSE	グース
GOP	ジーオーピー
Gorgias	ゴルギアス
gossip	ゴシップ
GOT	ジーオーティー
Gotemba	ゴテンバ
Gourmet	グルメ
government	ガバメント
Government	ガバメント
gp	ジーピー
GP	ジーピー
GP125	ジーピーヒャクニジューゴ
GP250	ジーピーニヒャクゴジュー
gpa	ジーピーエー
GPA	ジーピーエー
GPD	ジーピーディー
GPIB	ジーピーアイビー
GPM	ジーピーエム
GPN	ジーピーエヌ
GPRS	ジーピーアールエス
GPS	ジーピーエス
GPT	ジーピーティー
GPU	ジーピーユー
Grace	グレース
graduate	グラデュエート
Graduate	グラデュエート
Grammar	グラマー
GRAMPUS	グランパス
Grand	グランド
Grant	グラント
GRAPEVINE	グレープバイン
μgRE	マイクログラムレチノール
GRE	ジーアールイー
Great	グレート
GREAT	グレート
green	グリーン
Green	グリーン
GREEN	グリーン
grep	グレップ
GREP	グレップ
GREX	ジーレックス
grill	グリル
GRIP	ジーアールアイピー
GROOVE	グルーブ
Grosheide	グロシード
grotesque	グロテスク
grounds	グラウンズ
Group	グループ
GRT	ジーアールティー
GRUNK	ジーアールユーエヌケー
GS	ジーエス
GSAT	ジーサット
GSC	ジーエスシー
GSK	ジーエスケー
GSM	ジーエスエム
GSP	ジーエスピー
GSR	ジーエスアール
GSS	ジーエスエス
GT	ジーティー
GTA	ジーティーエー
GtC	ジーティーシー
GTC	ジーティーシー
GTE	ジーティーイー
gTLD	ジーティーエルディー
GTP	ジーティーピー
GTS	ジーティーエス
GU	ジーユー
GUAM	グアム
Gudhakesa	グダーケーシャ
GUI	ジーユーアイ
Guide	ガイド
GUIDE	ガイド
Gulf	ガルフ
GULLIVER	ガリバー
GUMP	ガンプ
gun	ガン
GUNDAM	ガンダム
GUNT	ジーユーエヌティー
Guttman	グートマン
GVA	ジーブイエー
GVW	ジーブイダブリュー
GW	ゴールデンウィーク
GWP	ジーダブリューピー
GX	ジーエックス
H	エッチ
H2ロケット	エイチツーロケット
H2TIMIT	エイチツーティミット
ha	ヘクタール
HA	エイチエイ
HABITAT	ハビタット
HACCP	ハサップ
Hachisch	ハシシュ
Hair	ヘア
HAKO	バコ
HAKU	ハク
Hakubun	ハクブン
HAL	エイチエイエル
HAL-O-ROID	ハルオロイド
HALAL	ハラール
HALBAU	ハルボー
half	ハーフ
Half	ハーフ
Hall	ホール
HALL	ホール
Hallin	ハリン
Halt	ハルト
HALWIN	ハルウィン
ham	ハム
HAMLET	ハムレット
Han	ハン
HANA‐BI	ハナビ
Hanako	ハナコ
hand	ハンド
Hand	ハンド
Handbook	ハンドブック
Hang	ハング
HAN‐MON	ハンモン
Hanoi	ハノイ
Happened	ハプンド
happy	ハッピー
Happy	ハッピー
HAPPY	ハッピー
HARADA	ハラダ
hard	ハード
HARDWEAR	ハードウェア
Harris	ハリス
Hat	ハット
Hatano	ハタノ
HATS	ハッツ
have	ハブ
HAVE	ハブ
HB	エイチビー
HBC	エイチビーシー
HBFC	エイチビーエフシー
HBO	エイチビーオー
HC	エイチシー
HCB	エイチシービー
HCFC	エイチシーエフシー
HCR	エイチシーアール
HCRM	エイチシーアールエム
HD	エイチディー
HDD	エッチディーディー
HDI	エイチディーアイ
HDLC	エイチディーエルシー
HDMI	エイチディーエムアイ
HDTV	エイチディーティーブイ
He	エイチイー
HE	エイチイー
HEAD	ヘッド
headline	ヘッドライン
Headline	ヘッドライン
Heads	ヘッズ
Health	ヘルス
Heart	ハート
Heaven	ヘブン
HEC	エイチイーシー
HEFC	エイチイーエフシー
HEIWA	ヘイワ
Hello	ハロー
help	ヘルプ
Help	ヘルプ
Hematoporphyrin	ヘマトポルフィリン
HEMS	エイチイーエムエス
HENDEL	エイチイーエヌディーイーエル
Hendrick	ヘンドリック
Henle	ヘンレ
hennkann	ヘンカン
Henry	ヘンリー
HEP	ヘップ
Hepburn	ヘップバーン
her	ハー
HERAS	ヘラス
here	ヒア
Here	ヒア
HEY	ヘイ
HF	エイチエフ
HFBC	エイチエフビーシー
HFC	エイチエフシー
HFI	エイチエフアイ
HFIR	エイチエフアイアール
HFM	エイチエフエム
HFSP	エイチエフエスピー
Hg	エイチジー
HGA	エイチジーエイ
HHI	エイチエイチアイ
Hi	ハイ
HI	ハイ
Hi8	ハイエイト
HIC	エイチアイシー
HID	エイチアイディー
hide	ヒデ
Hidenao	ヒデナオ
Hieroglyphics	ヒデログリフィクス
high	ハイ
High	ハイ
Highway	ハイウエー
HIKIKOMORI	ヒキコモリ
Hilbert	ヒルベルト
Hill	ヒル
hilton	ヒルトン
HIMR	エイチアイエムアール
hint	ヒント
HINT	ヒント
HIOKI	ヒオキ
HIP	ヒップ
HIPC	エイチアイピーシー
Hiraly	ヒラリー
Hiroki	ヒロキ
Hirose	ヒロセ
Hiroshi	ヒロシ
HIROSHIMA	ヒロシマ
his	ヒズ
HIS	エイチアイエス
history	ヒストリー
History	ヒストリー
HIT	ヒット
HITACHI	ヒタチ
HITEN	ヒテン
Hitotsubashi	ヒトツバシ
HITS	ヒッツ
HIV	エイチアイブイ
HLA	エイチエルエイ
HM	エイチエム
HMC	エイチエムシー
HMM	エイチエムエム
HMMLR	エイチエムエムエルアール
HMS	エイチエムエス
HMV	エイチエムブイ
HNP	エイチエヌピー
Hold	ホールド
hole	ホール
Holland	ホランド
Holy	ホーリー
home	ホーム
Home	ホーム
HOME	ホーム
homo	ホモ
HONDA	ホンダ
HONEST	オネスト
Honey	ハニー
HONEY	ハニー
HOP	ホップ
Hope	ホープ
HOPE	ホープ
Hopkins	ホプキンス
Horace	ホレス
Horoscope	ホロスコープ
horse	ホース
Hot	ホット
HOTケーキ	ホットケーキ
hotel	ホテル
Hotel	ホテル
HOTEL	ホテル
house	ハウス
HOUSE	ハウス
Houston	ヒューストン
how	ハウ
HOYA	ホーヤ
Hp	エイチピー
HP	エイチピー
hpa	ヘクトパスカル
hPa	ヘクトパスカル
HPD	エイチピーディー
HPSG	エイチピーエスジー
HR	エイチアール
HRD	エイチアールディー
HRM	エイチアールエム
HRST	エイチアールエスティー
HRTF	エイチアールティーエフ
HS	エイチエス
HSDPA	エイチエスディーピーエイ
HSS	エイチエスエス
HSST	エイチエスエスティー
hst	エイチエスティー
HST	エイチエスティー
HT	エイチティー
HTB	エイチティービー
HTC	エイチティーシー
HTK	エイチティーケー
HTL	エイチティーエル
HTLV	エイチティーエルブイ
htm	エイチティーエム
HTM	エイチティーエム
html	エイチティーエムエル
HTML	エイチティーエムエル
hts	エイチティーエス
Hts	エイチティーエス
HTS	エイチティーエス
hts engine	エイチティーエスエンジン
Hts Engine	エイチティーエスエンジン
HTS ENGINE	エイチティーエスエンジン
hts_engine	エイチティーエスエンジン
Hts_Engine	エイチティーエスエンジン
HTS_ENGINE	エイチティーエスエンジン
htsengine	エイチティーエスエンジン
HtsEngine	エイチティーエスエンジン
HTSENGINE	エイチティーエスエンジン
http	エイチティーティーピー
HTTP	エイチティーティーピー
HTTR	エイチティーティーアール
HUGO	ヒューゴ
Hulu	フールー
human	ヒューマン
Human	ヒューマン
hundred	ハンドレッド
Hunt	ハント
Hussy	ハッシー
HVXC	エイチブイエックスシー
Hybrid	ハイブリッド
Hz	ヘルツ
i	イチ
I	イチ
I&S	アイアンドエス
IA	アイエー
IAAF	アイエーエーエフ
IAC	アイエーシー
IACC	アイエーシーシー
IAEA	アイエイイーエイ
IAI	アイエーアイ
IANA	アイエーエヌエー
IAP	アイエーピー
IATA	アイエイティーエイ
IATTC	アイエーティーティーシー
IAU	アイエイユー
IB	アイビー
IBC岩手放送	アイビーシーイワテホーソー
IBF	アイビーエフ
IBL	アイビーエル
IBM	アイビーエム
IBPGR	アイビーピージーアール
IBRD	アイビーアールディー
IBU	イブ
Ibuki	イブキ
IBUKI	イブキ
IC	アイシー
ICA	アイシーエー
ICANN	アイシーエーエヌエヌ
ICAO	アイシーエーオー
icassp	アイキャスプ
Icassp	アイキャスプ
ICASSP	アイキャスプ
ICBM	アイシービーエム
ICC	アイシーシー
ICCAT	アイシーシーエーティー
ICCP	アイシーシーピー
ICD	アイシーディー
ICDDR	アイシーディーディーアール
Ice	アイス
ICE	アイス
ICF	アイシーエフ
ICHIRO	イチロー
ICI	アイシーアイ
ICID	アイシーアイディー
Icing	アイシング
ICJ	アイシージェイ
ICLE	イクル
ICLEI	アイシーエルイーアイ
ICMAS	イクマス
ICOC	アイシーオーシー
ICORC	アイシーオーアールシー
ICOT	アイコット
ICPD	アイシーピーディー
ICPhS	アイシーピーエイチエス
ICPO	アイシーピーオー
ICPSR	アイシーピーエスアール
ICQ	アイシーキュー
ICRC	アイシーアールシー
ICRISAT	アイシーアールアイエスエーティー
ICRP	アイシーアールピー
ICRU	アイシーアールユー
ICSLP	アイシーエスエルピー
ICSTD	アイシーエスティーディー
ICSU	アイシーエスユー
ICT	アイシーティー
ICU	アイシーユー
id	アイディー
iD	アイディ
ID	アイディー
IDA	アイディーエー
IDB	アイディービー
IDC	アイディーシー
IDDN	アイディーディーエヌ
IDE	アイディーイー
IDEA	アイディーイーエー
Identification	アイデンティフィケーション
IDF	アイディーエフ
IDGコミュニケーションズ	アイディージーコミュニケーションズ
IDHEC	アイディーエイチイーシー
IDNDR	アイディーエヌディーアール
IDO	イドー
IDS	アイディーエス
IE	アイイー
IEA	アイイーエー
IEC	アイイーシー
IEEE	アイトリプルイー
IES	アイイーエス
IETF	アイイーティーエフ
if	イフ
If	イフ
IF	イフ
IFAD	アイエフエーディー
IFC	アイエフシー
IFJ	アイエフジェー
IFO	アイエフオー
IFOR	アイエフオーアール
IFP	アイエフピー
IFRB	アイエフアールビー
IFRC	アイエフアールシー
IFREMER	アイエフアールイーエムイーアール
IFS	アイエフエス
IFWP	アイエフダブリューピー
Ig	アイジー
IG	アイジー
IGBP	アイジービーピー
IGC	アイジーシー
IGCC	アイジーシーシー
IGCP	アイジーシーピー
IGES	アイジーイーエス
IGGI	アイジージーアイ
IGL健康福祉専門学校	アイジーエルケンコーフクシセンモンガッコー
IGR	アイジーアール
IH	アイエイチ
IHI	アイエイチアイ
IHP	アイエイチピー
ii	ニ
II	ニ
IIC	アイアイシー
iii	サン
III	サン
IIP	アイアイピー
IIR	アイアイアール
IISS	アイアイエスエス
IK	アイケー
IKEA	イケア
ikegami	イケガミ
IKENOHIRA	イケノヒラ
ILAC	アイエルエーシー
ILGA	アイエルジーエイ
Illinois	イリノイ
Illust.	イラスト
illustration	イラストレーション
Illustrator	イラストレーター
ILO	アイエルオー
ILP	アイエルピー
ILRAD	アイエルアールエーディー
ILS	アイエルエス
iMac	アイマック
IMAGICA	イマジカ
IMCO	アイエムシーオー
IMDG	アイエムディージー
IME	アイエムイー
IMF	アイエムエフ
IML	アイエムエル
IML2	アイエムエルニ
IMnet	アイエムエヌイーティー
IMNET	アイエムエヌイーティー
IMO	アイエムオー
i−mode	アイモード
i−MODE	アイモード
I−mode	アイモード
I−MODE	アイモード
IMP	アイエムピー
Impact	インパクト
IMPATT	インパット
Imperial	インペリアル
import	インポート
important	インポータント
Impressions	インプレッションズ
Improvement	インプルーブメント
IMT	アイエムティー
IMTS	アイエムティーエス
in	イン
In	イン
IN	イン
IN KYOTO	インキョート
INABA	イナバ
Inagaki	イナガキ
INAIL	アイエヌエーアイエル
INAM	アイエヌエーエム
INAX	イナックス
INB	アイエヌビー
Inc	インク
INC	インク
include	インクルード
income	インカム
Incomplete	インコンプリート
IND	アイエヌディー
independent	インディペンデント
Independent	インディペンデント
index	インデックス
INDEX	インデックス
Indian	インディアン
individual	インディビジュアル
Individual	インディビジュアル
INDSCAL	インスカル
industrial	インダストリアル
Industrial	インダストリアル
Industry	インダストリー
INED	イネド
INES	アイエヌイーエス
INF	アイエヌエフ
infancy	インファンシー
INFCE	アイエヌエフシーイー
INFCIRC	アイエヌエフシーアイアールシー
in‐finit	インフィニット
info	インフォ
Info	インフォ
information	インフォメーション
Information	インフォメーション
INFORMATION	インフォメーション
INFOTERRA	インフォテラ
ing	イング
Ingress	イングレス
Ingrid	イングリッド
INIS	アイエヌアイエス
Init	イニット
INIT	イニット
INMARSAT	インマルサット
INPS	アイエヌピーエス
input	インプット
Input	インプット
INR	アイエヌアール
INRA	アイエヌアールエー
INRO	アイエヌアールオー
INS	アイエヌエス
INSAG	アイエヌエスエージー
INSEE	アイエヌエスイーイー
INSERM	アイエヌエスイーアールエム
INSERT	インサート
INSPEC	インスペック
Instagram	インスタグラム
Institute	インスティチュート
Institution	インスティチューション
int	アイエヌティー
INT	アイエヌティー
Intec	インテック
INTEGRA	インテグラ
Integration	インテグレーション
intel	インテル
Intel	インテル
INTELSAT	インテルサット
intensity	インテンシティー
interest	インタレスト
Interest	インタレスト
INTERESTING	インタレスティング
Interface	インターフェース
international	インターナショナル
International	インターナショナル
iNTERNET	インターネット
Internet	インターネット
INTERREG	インターレグ
interspeech	インタースピーチ
Interspeech	インタースピーチ
INTERSPEECH	インタースピーチ
interview	インタビュー
Interview	インタビュー
INTERVIEW	インタビュー
intimate	インティメート
Int’l	インターナショナル
INTOR	アイエヌティーオーアール
introduction	イントロダクション
Intrusion	イントリューション
Intuit	インチュイット
Investment	インベストメント
involvement	インボルブメント
INWAC	アイエヌダブリューエーシー
IO	アイオー
IOC	アイオーシー
IOM	アイオーエム
iOS	アイオーエス
IP	アイピー
IPA	アイピーエー
iPad	アイパッド
IPAL	アイパル
IPC	アイピーシー
IPCC	アイピーシーシー
ipconfig	アイピーシーオーエヌエフアイジー
IPCONFIG	アイピーシーオーエヌエフアイジー
IPCS	アイピーシーエス
IPDL	アイピーディーエル
IPDR	アイピーディーアール
IPF	アイピーエフ
iPhone	アイフォン
IPI	アイピーアイ
IPO	アイピーオー
iPod	アイポッド
IPPF	アイピーピーエフ
iPS	アイピーエス
IPS	アイピーエス
IPsec	アイピーエスイーシー
IPSEC	アイピーエスイーシー
IPTF	アイピーティーエフ
IPU	アイピーユー
IPv	アイピーブイ
IPV	アイピーブイ
iQ	アイキュー
IQ	アイキュー
Ir	アイアール
IR	アイアール
IRA	アイアールエイ
IRAS	アイアールエーエス
IRBM	アイアールビーエム
IRC	アイアールシー
IREX	アイレックス
iRIVER	アイリバー
IRN	アイアールエヌ
IRPTC	アイアールピーティーシー
IRRI	アイアールアールアイ
IRRT	アイアールアールティー
IRS	アイアールエス
IRSA	アイアールエスエー
IRST	アイアールエスティー
IRT	アイアールティー
is	イズ
IS	イズ
ISBN	アイエスビーエヌ
ISCA	イスカ
ISD	アイエスディー
ISDB	アイエスディービー
ISDN	アイエスディーエヌ
ISDR	アイエスディーアール
ISDS	アイエスディーエス
Ishihara	イシハラ
ISI	アイエスアイ
ISIC	アイエスアイシー
ISIS	アイエスアイエス
ISKRA	イスクラ
ISL	アイエスエル
ISLAND	アイランド
ISM	アイエスエム
iso	アイエスオー
ISO	アイエスオー
ISP	アイエスピー
ISR	アイエスアール
Israel	イスラエル
ISS	アイエスエス
ISSA	イッサ
ISSAY	イッセイ
Issue	イシュー
ISTA	アイエスティーエー
ISTAT	アイエスティーエーティー
ISTC	アイエスティーシー
ISY	アイエスワイ
It	イット
IT	アイティー
世界三大IT技術展	セカイ:サンダイ:アイティーギジュツテン
ITA	アイティーエー
ITB	アイティービー
ITBL	アイティービーエル
ITC	アイティーシー
ITD	アイティーディー
ITER	アイティーイーアール
Iterator	イテレーター
ITF	アイティーエフ
ITIT	アイティーアイティー
ITJ	アイティージェイ
ITM	アイティーエム
ITO	アイティーオー
It’s	イッツ
ITS	アイティーエス
ITT	アイティーティー
ITTA	アイティーティーエー
ITTF	アイティーティーエフ
ITTO	アイティーティーオー
ITU	アイティーユー
ITV	アイティーブイ
IUCN	アイユーシーエヌ
IUD	アイユーディー
IUOTO	アイユーオーティーオー
IUPAC	アイユーピーエーシー
iv	ヨン
IV	ヨン
IVR	アイブイアール
IWC	アイダブリューシー
ix	キュー
IX	キュー
IYV	アイワイブイ
J子	ジェーコ
J.P.モルガン	ジェイピーモルガン
J/cal	ジュールマイカロリー
J/s	ジュールマイビョー
JA	ジェイエイ
JAA	ジェーエーエー
JAB	ジェーエービー
JABEE	ジェーエービーイーイー
Jacintha	ジャシンタ
Jack	ジャック
Jackson	ジャクソン
Jacob	ジェーコブ
JaeSuk	ジェソク
JAF	ジャフ
JAFL	ジャフル
JAFMATE社	ジェイエイエフメイトシャ
JAIST	ジャイスト
JAISTS	ジャイスツ
JAL	ジャル
JALANA	ジャラナ
JAM	ジャム
Jam Jam	ジャムジャム
JAMA	ジェーエーエムエー
James	ジェームズ
JAMES	ジェームズ
JAMP	ジャンプ
JAN	ジェーエーエヌ
Janos	ヤーノシュ
japan	ジャパン
Japan	ジャパン
JAPAN	ジャパン
Japanese	ジャパニーズ
Japio	ジャピオ
JARO	ジェーエーアールオー
JAS	ジャス
JASA	ジェーエーエスエー
JASC	ジェーエーエスシー
JASDAQ	ジャスダック
JASIC	ジェーエーエスアイシー
JASON	ジェーソン
JASPAS	ジェーエーエスピーエーエス
JASRAC	ジャスラック
JASREP	ジェーエーエスアールイーピー
JASTPRO	ジェーエーエスティーピーアールオー
JATP	ジェーエーティーピー
java	ジャバ
Java	ジャバ
JAVA	ジャバ
JAWOC	ジェーエーダブリューオーシー
JAXA	ジャクサ
Jazz	ジャズ
JAZZ	ジャズ
JBC	ジェービーシー
JBIC	ジェービーアイシー
JBP	ジェービーピー
JC	ジェイシー
JCB	ジェイシービー
JCIF	ジェーシーアイエフ
JCJ	ジェイシージェイ
JCO	ジェーシーオー
JCSAT	ジェーシーエスエーティー
JCT	ジェーシーティー
JDC	ジェイディーシー
JDR	ジェーディーアール
Jean	ジャン
Jeb	ジェフ
JEFLL	ジェッフル
JEGS	ジェーイージーエス
JEIDA	ジェイダ
JEITA	ジェーイーアイティーエー
JEM	ジェーイーエム
Jessica	ジェシカ
JET	ジェーイーティー
JETRO	ジェトロ
JETTV	ジェーイーティーティーブイ
JEUGIA	ジュージヤ
JEV	ジェイイーブイ
JEWELRY	ジュエリー
JEXR	ジェーイーエックスアール
JFA	ジェイエフエー
JFE	ジェーエフイー
JFK	ジェイエフケイ
JFL	ジェイエフエル
JFT	ジェーエフティー
JGN	ジェージーエヌ
JHC	ジェイエイチシー
JHDM	ジェーエイチディーエム
JHFA	ジェーエイチエフエイ
JHP	ジェーエイチピー
JIB	ジブ
JIC	ジェーアイシー
JICA	ジャイカ
JICST	ジェーアイシーエスティー
JICWELS	ジェーアイシーダブリューイーエルエス
JILAF	ジェーアイエルエーエフ
JILPT	ジェーアイエルピーティー
JIPPA	ジェーアイピーピーエー
JIS	ジス
JISS	ジェーアイエスエス
JITC	ジェイアイティーシー
Jive	ジャイブ
JJ	ジェージェー
JL2	ジェイエルニ
JMH	ジェーエムエイチ
JMLE	ジェーエムエルイー
JMS	ジェイエムエス
JMTDR	ジェーエムティーディーアール
JMTR	ジェーエムティーアール
JNAS	ジェーナス
JNB	ジェーエヌビー
JNN	ジェイエヌエヌ
JNTO	ジェーエヌティーオー
JOA	ジェーオーエー
Joaquin	ホアキン
Jobs	ジョブズ
JOC	ジェイオーシー
JOCV	ジェーオーシーブイ
JOCX	ジェーオーシーエックス
JODCO	ジェーオーディーシーオー
John	ジョン
JOHN	ジョン
Johnson	ジョンソン
Joint	ジョイント
JOIS	ジョイス
JOMO	ジョモ
JOMO CUP	ジョモカップ
Joseph	ジョゼフ
Journal	ジャーナル
JOURNEY	ジャーニー
JOYSOUND	ジョイサウンド
jp	ジェーピー
JP	ジェーピー
JPDR	ジェーピーディーアール
JPEG	ジェーペグ
JPG	ジェーペグ
JPN	ジェーピーエヌ
JPRS	ジェーピーアールエス
JPS	ジェーピーエス
Jr	ジュニア
JR	ジェイアール
JR東海	ジェイアール:トーカイ
JRA	ジェイアールエイ
JRCB	ジェーアールシービー
JRJ	ジェーアールジェー
JRR	ジェーアールアール
JSA	ジェーエスエー
JSAPI	ジェーサピ
JSB	ジェーエスビー
JSBA	ジェーエスビーエー
JSD	ジェーエスディー
JSL	ジェーエスエル
jsp	ジェーエスピー
Jsp	ジェーエスピー
JSP	ジェイエスピー
JSR	ジェイエスアール
JSS	ジェーエスエス
JST	ジェーエスティー
JT	ジェイティー
JTAG	ジェータグ
JTB	ジェイティービー
JTC	ジェーティーシー
JTEC	ジェーティーイーシー
JTFEX	ジェーティーエフイーエックス
JToBI	ジェートビ
judge	ジャッジ
Judo	ジュードー
JUKI	ジューキ
JULI	ジェーユーエルアイ
Julia	ジュリア
Julian	ジュリアン
julius	ジュリアス
Julius	ジュリアス
JULIUS	ジュリアス
July	ジュライ
JUMAN	ジュマン
Jump	ジャンプ
Jun	ジュン
June	ジュン
Jungle	ジャングル
Junior	ジュニア
JUON	ジュオン
JUPP	ジェーユーピーピー
JUSE	ジュース
just	ジャスト
Justice	ジャスティス
JVC	ジェイブイシー
J−WAVE	ジェイウェーブ
おk	オーケー
K太	ケータ
K2	ケーツー
KADOKAWA	カドカワ
KADS	カッズ
KAI	カイ
Kaifu	カイフ
KAITO	カイト
KAIYO	カイヨー
KAIZEN	カイゼン
KAJ	ケーエージェー
Kajima	カジマ
KAL	ケーエーエル
KAMILA	カミラ
KANU	カヌ
Kaoka	カオカ
Kaoru	カオル
Kaplan	カプラン
Kashima	カシマ
Katharine	キャサリン
Kato	カトー
KATO	カトー
Katrin	キャサリン
KAT‐TUN’s	カトゥーンズ
KAUS	カウス
KAWA	カワ
Kawabata	カワバタ
Kawakita	カワキタ
Kayano	カヤノ
KAZOKU	カゾク
Kazunori	カズノリ
KAZUYA	カズヤ
kb	キロバイト
Kb	キロバイト
KB	キロバイト
kB/s	キロビーピーエス
KBC	ケービーシー
KBL	ケービーエル
kbps	キロビーピーエス
kBps	キロビーピーエス
Kbps	ケービーピーエス
KBq	キロベクレル
KBS	ケイビーエス
KC	ケーシー
kcal	キロカロリー
Kcal	キロカロリー
KCIA	ケーシーアイエー
KCNO	ケーシーエヌオー
KCS	ケイシーエス
KCW	ケーシーダブリュー
KDD	ケイディーディー
KDDI	ケーディーディーアイ
KDE	ケーディーイー
KDK	ケイディーケイ
KDX	ケーディーエックス
KEDO	ケイイーディーオー
KEEI	ケーイーイーアイ
Keep	キープ
Keeping	キーピング
KEGG	ケーイージージー
KEK	ケーイーケー
Kellin	ケリン
Kelly	ケリー
Ken’s	ケンズ
Kepler	ケプラー
kernel	カーネル
Key	キー
Keyboard	キーボード
KF	ケーエフ
KFAED	ケーエフエーイーディー
KfK	ケーエフケー
KFK	ケーエフケー
kg	キログラム
Kg	キログラム
KG	ケージー
kg/m3	キログラムマイリッポーメートル
KGB	ケイジービー
兼松KGK	カネマツケージーケー
kgU	キログラムウラン
KHV	ケーエイチブイ
kHz	キロヘルツ
KIビル	ケイアイビル
kid	キッド
kid’s	キッズ
Kids	キッズ
KID’s	キッズ
KIKI	キキ
killer	キラー
Kimura	キムラ
Kinderhook	キンダーフック
Kingdom	キングダム
Kinki	キンキ
KinKi	キンキ
KINUTA	キヌタ
KINYA	キンヤ
Kiroro	キロロ
KIRORO	キロロ
Kis‐My‐Ft	キスマイフット
kiss	キス
Kiss	キス
KISS	キス
Kiss—FMKOBE	キスーエフエムコーベ
KISTI	ケーアイエスティーアイ
kit	キット
Kit	キット
Kitamura	キタムラ
kJ	キロジュール
KJ	ケージェー
kJ/mol	キロジュールマイモル
KK	ケーケー
KKK	ケーケーケー
KKR	ケーケーアール
kl	キロリットル
Kl	キロリットル
KLASSI	クラッシー
Klaus	クラウス
km	キロメートル
Km	キロメートル
km/時	キロメートルマイジ
km/h	キロメートルマイジ
km/l	キロメートルマイリットル
km/s	キロメートルマイビョー
km2	ヘーホーキロメートル
K・MIX	ケイミックス
KMK	ケーエムケー
KMN	ケーエムエヌ
KNK	ケーエヌケー
KNO	ケーエヌオー
Knoppix	クノーピクス
know	ノー
KNP	ケーエヌピー
KO	ケイオー
KOA	コーア
Kobayashi	コバヤシ
KOBE	コーベ
KODAK	コダック
KODS	ケーオーディーエス
kogen	コーゲン
KOICA	ケーオーアイシーエー
koji	コージ
Koji	コージ
Kojima	コジマ
KOK	コク
kokotoki	ココトキ
KOOKAI	クーカイ
Korea	コリア
KOREA	コリア
KOTONOHA	コトノハ
KOWA	コーワ
kPa	キロパスカル
KPH	ケーピーエイチ
KPN	ケーピーエヌ
Kr	ケーアール
KR	ケーアール
KRAPS	クラップス
Krauss	クラウス
KRRP	ケーアールアールピー
KS	ケーエス
KSD	ケーエスディー
KSDA	ケーエスディーエー
KSP	ケーエスピー
KSS	ケーエスエス
kt	キロトン
Kt	キロトン
KTV	ケーティーブイ
Kukulcan	ククルカン
KUMAKO	クマコ
KUWAIT	クウェート
KV	キロボルト
Kv.	ケッヘル
KVA	キロボルトアンペア
KVK	ケイブイケイ
kw	キロワット
kW	キロワット
KW	キロワット
kW/m2	キロワットマイヘーホーメートル
kWh	キロワットアワー
KYO	キョー
KYOTO	キョート
KYUSHU	キューシュー
l	リットル
L.G.B	エルジービー
LA	エルエー
La Venta	ラベンタ
Laborato‐ries	ラボラトリーズ
LAD	エルエーディー
LAeq	エルエーイーキュー
Lag	ラグ
LAN	ラン
LAND	ランド
Landsat	ランドサット
Lane	レーン
LANE	レーン
lang	ラング
Langton	ラングトン
language	ランゲージ
Language	ランゲージ
Languages	ランゲージズ
Lapis	ラピス
large	ラージ
LAS	エルエーエス
last	ラスト
Last	ラスト
late	レート
LaTeX	ラテフ
law	ロー
layout	レイアウト
Lazuli	ラズリ
lb	ポンド
Lb	エルビー
LB	エルビー
LBB	エルビービー
LBC	エルビーシー
LBG	エルビージー
LBH	エルビーエイチ
LC	エルシー
lca	エルシーエー
LCA	エルシーエー
LCAT	エルシーエーティー
LCD	エルシーディー
LCS	エルシーエス
LD	エルディー
LDC	エルディーシー
LDK	エルディーケイ
LDN	エルディーエヌ
LDP	エルディーピー
LDS	エルディーエス
le	ル
LE	エルイー
Lead	リード
League	リーグ
learn	ラーン
learning	ラーニング
Learning	ラーニング
LEC	レック
LED	エルイーディー
LEE	リー
Leeuwenhoek	レーウェンフック
Left	レフト
legs	レッグス
Lemon	レモン
Lender’s	レンダーズ
Lenovo	レノボ
LEO	レオ
LEQ	エルイーキュー
L’EQUIPE	レキップ
les	レ
LES	レ
Lesnik	レスニック
Lesson	レッスン
LESSON	レッスン
LET	エルイーティー
LEtnA	エルイーティーエヌエー
LETNA	エルイーティーエヌエー
Let’s	レッツ
letter	レター
Letter	レター
level	レベル
Level	レベル
Lewis	ルイス
LF	エルエフ
LFCM	エルエフシーエム
LFG	エルエフジー
LG	エルジー
LHカー	エルエイチカー
Li	エルアイ
LI	エルアイ
libc	エルアイビーシー
Liberal	リベラル
LIBRA	リブラ
library	ライブラリー
Library	ライブラリー
LICs	エルアイシーエス
life	ライフ
Life	ライフ
LIFE	ライフ
light	ライト
Light	ライト
LIGHT	ライト
like	ライク
LiLFeS	リルフェス
LILFES	リルフェス
LILY	リリー
Limited	リミテッド
Lincoln	リンカーン
Linda	リンダ
LINDO	リンド
LINDSEI	リンゼイ
line	ライン
Line	ライン
LINE	ライン
LINEAR	エルアイエヌイーエーアール
Link	リンク
LINK	リンク
Linux	リナックス
LISA	エルアイエスエー
LISP	リスプ
Listener	リスナー
Listening	リスニング
Literature	リテラチュア
little	リトル
Little	リトル
Litwak	リトワック
LIV	リブ
Live	ライブ
LIVE	ライブ
living	リビング
Living	リビング
LL	エルエル
LLCD	エルエルシーディー
LLDC	エルエルディーシー
LLT	エルエルティー
LMA	エルエムエー
LME	エルエムイー
LNG	エルエヌジー
LO	エルオー
load	ロード
Loan	ローン
LOC	エルオーシー
LOCA	エルオーシーエー
local	ローカル
Local	ローカル
Lock	ロック
LOCOS	ロコス
LOEWY	ローウィ
LOFT	ロフト
log	ログ
LOGO	ロゴ
Lomb	ロム
Lomo	ロモ
LON	ロン
London	ロンドン
lonely	ロンリー
long	ロング
Long	ロング
LOOC	エルオーオーシー
Look	ルック
LOOK	ルック
lookup	ルックアップ
LOOKUP	ルックアップ
LORAN	ロラン
lorazepam	ロラゼパム
loss	ロス
lost	ロスト
Lost	ロスト
LOST	ロスト
LOUNGE	ラウンジ
love	ラブ
Love	ラブ
LOVE	ラブ
Low	ロー
LP	エルピー
LPC	エルピーシー
LPCM	エルピーシーエム
LPD	エルピーディー
LPG	エルピージー
LPS	エルピーエス
LR	エルアール
LRC	エルアールシー
LRT	エルアールティー
LRV	エルアールブイ
LS	エルエス
LSA	エルエスエー
LSD	エルエスディー
LSE	エルエスイー
LSI	エルエスアイ
LSP	エルエスピー
LSPB	エルエスピービー
LT	エルティー
LTA	エルティーエー
LTAG	エルタグ
LTCB	エルティーシービー
LTDP	エルティーディーピー
LTTE	エルティーティーイー
LUCK	ラック
Ludivine	リュディビーヌ
Ludwig	ラディック
Lumen	ルーメン
Lumenis	ルミナス
LUMO	ルモ
LUNAR	エルユーエヌエーアール
Luong	ルオン
Lutetium	ルテチウム
Lutex	エルユーティーイーエックス
LUTEX	エルユーティーイーエックス
LUV	エルユーブイ
Lv	エルブイ
LV	エルブイ
LVCSR	エルブイシーエスアール
LVL	エルブイエル
LX	エルエックス
LYNX	リンクス
Lyons	ライアンズ
lyric	リリック
Lyric	リリック
LYRIC	リリック
LZH	エルゼットエイチ
m‐	メタ
M	メガ
M.O.P.	エムオーピー
m/秒	メートルマイビョー
m/s	メートルマイビョー
m/s2	メートルマイビョーマイビョー
M1A2	エムイチエイニ
m2	ヘーホーメートル
M2TIMIT	エムツーティミット
m3	リッポーメートル
M40A1	エムヨンゼロエイイチ
mA	ミリアンペア
MA	エムエー
MAB	エムエービー
MABC	マビック
Mac	マック
MAC	エムエーシー
machine	マシン
Machine	マシン
MACHINE	マシン
Macintosh	マッキントッシュ
Macmillan	マクミラン
macOS	マックオーエス
MADE	メード
MADHU	マドゥ
Madl	マードル
MAFFIN	エムエーエフエフアイエヌ
Magazine	マガジン
Magic	マジック
Magnet	マグネット
MAGNET	マグネット
Magret	マグレ
MAGSAT	マグサット
mail	メール
Mail	メール
Main	メーン
MAIN	メーン
Maintenance	メンテナンス
MAJIO	マジオ
Major	メジャー
Majors	メジャーズ
make	メーク
Make	メーク
MAKING	メーキング
MALT	モルト
MAMA	ママ
man	マン
Man	マン
MAN	マン
management	マネージメント
Management	マネージメント
MANAGEMENT	マネージメント
Manager	マネージャー
Managing	マネージング
maniac	マニアック
manics	マニックス
MANPADS	エムエーエヌピーエーディーエス
MANTLE	マントル
Manual	マニュアル
MANUAL	マニュアル
map	マップ
Map	マップ
MAP	マップ
MAR	エムエーアール
March	マーチ
MARCH	マーチ
Maria	マリア
Marie	マリエ
MariMari	マリマリ
Marine	マリン
Mark	マーク
MARK	エムエーアールケー
market	マーケット
Market	マーケット
Marketing	マーケティング
Marks	マークス
Marmot	マーモット
MARPOL	エムエーアールピーオーエル
MARS	マーズ
Marshall	マーシャル
Martha	マーサ
Martin	マーチン
MARU	マル
MaRV	マーブ
MARV	マーブ
Mary	メアリー
MASA	マサ
Masahiko	マサヒコ
MASQUERADE	マスカレード
Mass	マス
massage	マッサージ
Massage	マッサージ
master	マスター
masterpiece	マスターピース
Master’s	マスターズ
Masuhiro	マスヒロ
Masumi	マスミ
MATLAB	マトラブ
Matrox	マトロックス
Matsumoto	マツモト
MAU	マウ
Max	マックス
MAX	マックス
Maxtor	マックストア
MAYER	マイヤー
mayu	マユ
Mazzini	マッツィーニ
mb	ミリバール
Mb	メガバイト
MB	メガバイト
MB/s	メガビーピーエス
MBA	エムビーエー
MBF	エムビーエフ
MBFR	エムビーエフアール
mbH	エムビーエイチ
Mbit	メガビット
Mbps	メガビーピーエス
MBps	メガビーピーエス
MBR	エムビーアール
MBS	エムビーエス
MBSAT	エムビーエスエーティー
MC	エムシー
MCA	エムシーエー
McAfee	マカフィー
MCC	エムシーシー
McDOWELL	マクダウェル
MCE	エムシーイー
MCI	エムシーアイ
MCMC	エムシーエムシー
MCPC	エムシーピーシー
MCT	エムシーティー
MD	エムディー
MDC	エムディーシー
MDF	エムディーエフ
MDGs	エムディージーエス
MDI	エムディーアイ
MDL	エムディーエル
MDMA	エムディーエムエー
MDP	エムディーピー
MDPREF	エムディープレフ
MDS	エムディーエス
me	ミー
Me	ミー
ME	エムイー
mean	ミーン
Mean	ミーン
MECO	エムイーシーオー
Medal	メダル
media	メディア
Media	メディア
medical	メディカル
Medical	メディカル
Medicare	メディケア
medicine	メディシン
medium	ミディアム
MEDLINE	メドライン
Meeting	ミーティング
MEG	メグ
Mega	メガ
MEI	エムイーアイ
MELA	メーラ
Melancholy	メランコリー
MELLOW	メロー
MELP	メルプ
member	メンバー
members	メンバーズ
memo	メモ
MEMO	メモ
memory	メモリー
Memory	メモリー
MEMS	エムイーエムエス
MEMTTA	エムイーエムティーティーエー
Men	メン
Mens	メンズ
MEN’S	メンズ
mental	メンタル
MEP	エムイーピー
Mephistophelis	メフィストフェレス
Mercado	メルカード
MERCOSUR	メルコスール
Merit	メリット
MERS	マーズ
MeSH	メッシュ
message	メッセージ
Message	メッセージ
MET	メット
METAL	メタル
METHOD	メソッド
METO	エムイーティーオー
METRO	メトロ
MeV	メブ
MF	エムエフ
MFA	エムエフエー
MFCC	エムエフシーシー
MFICU	エムエフアイシーユー
MFJ	エムエフジェイ
MFN	エムエフエヌ
mg	ミリグラム
Mg	エムジー
MG	エムジー
MGAP	エムジーエーピー
MGC	エムジーシー
MGM	エムジーエム
MGV	エムジーブイ
MH	エムエイチ
mhz	メガヘルツ
MHz	メガヘルツ
MI	エムアイ
MIA	エムアイエイ
Michael	マイケル
Michi	ミチ
Michigan	ミシガン
micro	マイクロ
microsoft	マイクロソフト
Microsoft	マイクロソフト
MicroSoft	マイクロソフト
MICROSOFT	マイクロソフト
mid	エムアイディー
MID	エムアイディー
Middle	ミドル
MIDI	ミディ
MID—SUMMER	ミッドサマー
MIF	エムアイエフ
MIG	ミグ
MIGA	エムアイジーエー
MIKE	マイク
miku	ミク
military	ミリタリー
MILK	ミルク
Millar	ミラー
Millennium	ミレニアム
Miller	ミラー
Milton	ミルトン
Mimicry	ミミクリー
min	ミン
MIN	エムアイエヌ
mind	マインド
Mind	マインド
Minecraft	マインクラフト
mini	ミニ
Mini	ミニ
Minimum	ミニマム
Ministry	ミニストリー
MIN—ON	ミンオン
Minor	マイナー
MIPRO	ミプロ
MIPS	ミップス
Miravant	ミラバント
MIROTIC	ミロティック
MIRV	マーブ
MIS	エムアイエス
Miss	ミス
Missile	ミサイル
Mission	ミッション
MISSION	ミッション
MISUMI	ミスミ
MIT	エムアイティー
Mitchell	ミッチェル
Mitigation	ミティゲーション
Mitomi	ミトミ
Miwako	ミワコ
mixi	ミクシー
Miyajima	ミヤジマ
Miyazawa	ミヤザワ
Miyoshi	ミヨシ
MJPI	エムジェーピーアイ
MK	エムケイ
MKSA単位系	エムケーエスエータンイケー
ml	ミリリットル
mL	ミリリットル
ML	エムエル
MLB	エムエルビー
MLLR	エムエルエルアール
MLPC	エムエルピーシー
MLR	エムエルアール
MLRS	エムエルアールエス
MLS	エムエルエス
MLSA	エムエルエスエー
MLSSS	エムエルエスエスエス
MLT	エムエルティー
mm	ミリメートル
MM	エムエム
mm2	ヘーホーミリメートル
mm3	リッポーミリメートル
MMA	エムエムエー
MMC	エムエムシー
mmdagent	エムエムディーエージェント
MMDAgent	エムエムディーエージェント
MMDAGENT	エムエムディーエージェント
MMF	エムエムエフ
MML	エムエムエル
MMP	エムエムピー
MMSE	エムエムエスイー
MMT	エムエムティー
Mn	エムエヌ
MN	エムエヌ
MNG	エムエヌジー
MNLF	エムエヌエルエフ
MNP	エムエヌピー
MNRU	エムエヌアールユー
MO	エムオー
MOA	エムオーエー
MOB	エムオービー
Mobile	モバイル
MOBILE	モビール
Mobility	モビリティー
ゴールドウィンmoda	ゴールドウィンモーダ
Modern	モダン
MODY	モディ
MOE	モエ
MOF	エムオーエフ
MOGA	エムオージーエー
MOJICO	モジコ
MOJO	モジョ
mol	モル
mol/l	モルマイリットル
molten	モルテン
MOMA	モマ
Monday	マンデー
Monet	モネ
MONEX	エムオーエヌイーエックス
money	マネー
Money	マネー
MONEY	マネー
Monjoie	モンジョワ
Mono	モノ
MONSTER	モンスター
mont‐bell	モンベル
Moon	ムーン
MOON	ムーン
Moore	ムーア
MOP	モップ
Moral	モラル
more	モア
More	モア
Morgan	モーガン
Morning	モーニング
Morro	モロ
Morro Bay	モロベイ
MOS	エムオーエス
MOSS	モス
mother	マザー
Mother	マザー
MOTHER’S	マザーズ
motion	モーション
Motion	モーション
Moto	モト
MOTOKO	モトコ
Motor	モーター
MoU	エムオーユー
MOU	エムオーユー
Mountain	マウンテン
MOUNTAIN	マウンテン
MOUS	マウス
mouse	マウス
Mouse	マウス
moussy	マウジー
mouth	マウス
MOV	エムオーブイ
Movement	ムーブメント
Movie	ムービー
moving	ムービング
MOW	エムオーダブリュー
MOX	モックス
Mozilla	モジラ
mp	エムピー
MP	エムピー
MPA	エムピーエイ
MPCA	エムピーシーエー
MPCs	エムピーシーエス
MPD	エムピーディー
mpeg	エムペグ
MPEG	エムペグ
MPFBT	エムピーエフビーティー
MPG	エムピージー
MPLA	エムピーエルエー
MPN	エムピーエヌ
MPR	エムピーアール
MPU	エムピーユー
MPV	エムピーブイ
MR	エムアール
Mr.	ミスター
MR.	ミスター
MRBM	エムアールビーエム
MRCテックス	エムアールシーテックス
MRECC	エムアールイーシーシー
MRI	エムアールアイ
MrJOHN	ミスタージョン
MrMax	ミスターマックス
MRS	エムアールエス
MRSA	エムアールエスエイ
MRT	エムアールティー
MRTA	エムアールティーエイ
MS	エムエス
Ms.	ミズ
MSA	エムエスエー
MSAC	エムエスエーシー
MSC	エムエスシー
MSD	エムエスディー
MSDHMM	エムエスディーエイチエムエム
MSI	エムエスアイ
MSLR	エムエスエルアール
MSN	エムエスエヌ
MSNBC	エムエスエヌビーシー
MSO	エムエスオー
MSS	エムエスエス
mSv	ミリシーベルト
MSVQ	エムエスブイキュー
MSW	エムエスダブリュー
MT	エムティー
MTB	エムティービー
MTCR	エムティーシーアール
MTN	エムティーエヌ
MTSAT	エムティーサット
MTV	エムティーブイ
MU	エムユー
Multilateral	マルチラテラル
Multiplexing	マルチプレクシング
mura	ムラ
Muroi	ムロイ
Murphy	マーフィー
MUSASHI	ムサシ
MUSE	ミューズ
MUSES	エムユーエスイーエス
Museum	ミュージアム
music	ミュージック
Music	ミュージック
MUSIC	ミュージック
MusicXML	ミュージックエクスエムエル
must	マスト
mV	ミリボルト
MV	メガボルト
MVC	エムブイシー
MVNO	エムブイエヌオー
MVP	エムブイピー
MVRDV	エムブイアールディーブイ
mW	ミリワット
MW	メガワット
MWA	エムダブリューエー
MWD	メガワットデー
MX	エムエックス
my	マイ
My	マイ
MY	マイ
Myb	エムワイビー
N太	エヌタ
N.T.T	エヌティーティー
N/A2	ニュートンマイアンペアマイアンペア
N/C	ニュートンマイクーロン
N/m	ニュートンマイメートル
N/Wb	ニュートンマイウェーバー
Na	エヌエー
NACCS	エヌエーシーシーエス
NACK5	ナックファイブ
NACS	ナックス
NACSIS	ナクシス
NAFL	ナフル
NAFTA	ナフタ
Nagato	ナガト
NAGRA	エヌエージーアールエー
NaI	エヌエーアイ
NAI	エヌエーアイ
NAIL	ネール
NAiNOA	ナイノア
NAIRU	エヌエーアイアールユー
NAIS	ナイス
NAIST	ナイスト
Nakajima	ナカジマ
NALA	ナラ
name	ネーム
NAND	ナンド
NANNI	ナンニ
NaNO	エヌエーエヌオー
NAOC	エヌエイオーシー
NAPM	エヌエイピーエム
narakah	ナラカ
narcissisme	ナルシシズム
narrowband	ナローバンド
NASA	ナサ
NASCA	ナスカ
NASCAR	ナスカー
NASDA	ナスダ
Nasdaq	ナスダック
NASDAQ	ナスダック
NASSCOM	エヌエーエスエスシーオーエム
NAT	ナット
nation	ネーション
national	ナショナル
National	ナショナル
Nationalism	ナショナリズム
Nations	ネーションズ
NATIS	エヌエーティーアイエス
NATO	ナトー
natural	ナチュラル
nature	ネーチャー
Nature	ネーチャー
Navi	ナビ
NAVITIME	ナビタイム
Navy	ネイビー
NAVY	ネービー
NBA	エヌビーエイ
NBC	エヌビーシー
NBER	エヌビーイーアール
NBK	エヌビーケイ
NBS	エヌビーエス
NC	エヌシー
NCA	エヌシーエイ
NCCS	エヌシーシーエス
日本NCD	ニホンエヌシーディー
NCN米国大学機構	エヌシーエヌベーコクダイガクキコー
日本NCR	ニホンエヌシーアール
NCTE	エヌシーティーイー
NDB	エヌディービー
NDC	エヌディーシー
NDF	エヌディーエフ
NDLC	エヌディーエルシー
NDP	エヌディーピー
NDR	エヌディーアール
Ne	エヌイー
NE	エヌイー
NEA	エヌイーエー
NEAR	エヌイーエーアール
NEC	エヌイーシー
NEC・HE	エヌイーシーエイチイー
NED	エヌイーディー
NEDO	エヌイーディーオー
NEEDS	ニーズ
NEET	ニート
negative	ネガティブ
negotiation	ネゴシエーション
Nehru	ネルー
NEO	ネオ
NEP	ネップ
NEPA	エヌイーピーエー
NEPAD	エヌイーピーエーディー
Neretti	ネレッティ
NERSA	エヌイーアールエスエー
NEST	ネスト
NESTI	エヌイーエスティーアイ
nesting	ネスティング
Nestle	ネスレ
net	ネット
Net	ネット
NET	ネット
Netflix	ネットフリックス
network	ネットワーク
Network	ネットワーク
NETWORK	ネットワーク
Neumann	ノイマン
never	ネバー
Never	ネバー
new	ニュー
New	ニュー
NEW	ニュー
New York	ニューヨーク
NEW YORK	ニューヨーク
New Zealand	ニュージーランド
news	ニュース
News	ニュース
NewS	ニュース
NEWS	ニュース
NewYork	ニューヨーク
next	ネクスト
Next	ネクスト
NEXT	ネクスト
Nextel	ネクステル
NFL	エヌエフエル
NFR	エヌエフアール
NFS	エヌエフエス
NG	エヌジー
NGC	エヌジーシー
ngHg	ナノグラムエイチジー
NGI	エヌジーアイ
ngNi	ナノグラムニッケル
NGO	エヌジーオー
NHK	エヌエイチケイ
NHL	エヌエイチエル
Ni	エヌアイ
NI	エヌアイ
NIC	エヌアイシー
NICCO	エヌアイシーシーオー
NICOLE	ニコル
niconico	ニコニコ
NICOS	ニコス
NICs	ニックス
NICS	ニックス
NICU	エヌアイシーユー
NIE	エヌアイイー
NIEO	エヌアイイーオー
NIEs	ニーズ
NIES	ニーズ
Nif	ニフ
NIF	エヌアイエフ
night	ナイト
Night	ナイト
NIGHT	ナイト
NIH	エヌアイエイチ
NIKE	ナイキ
Nikkei	ニッケイ
NIKKEI	ニッケイ
NIKON	ニコン
NiL	エヌアイエル
NIL	エヌアイエル
NIMA	エヌアイエムエー
NIMBY	ニンビー
NINE	ナイン
NINJA	ニンジャ
Ninjal	ニンジャル
NINJAL	ニンジャル
Nintendo	ニンテンドー
Nippon	ニッポン
NIRA	エヌアイアールエー
Nirex	エヌアイアールイーエックス
NIRS	エヌアイアールエス
NIS	エヌアイエス
NISA	エヌアイエスエー
NISAN	ニーサン
Nishikido	ニシキド
NIST	エヌアイエスティー
NITクラブ	ニットクラブ
NJK	エヌジェイケイ
NK	エヌケイ
NKK	エヌケイケイ
NLD	エヌエルディー
NLP	エヌエルピー
NLU	エヌエルユー
nm	ナノメートル
N・m2/Wb2	ニュートンヘーホーメートルマイウェーバーマイウェーバー
NM3	エヌエムサン
NMD	エヌエムディー
NMR	エヌエムアール
NMS	エヌエムエス
NMSU	エヌエムエスユー
NMVOC	エヌエムブイオーシー
NNC	エヌエヌシー
NNM	エヌエヌエム
NNS	エヌエヌエス
NNSR	エヌエヌエスアール
NNSS	エヌエヌエスエス
NNW	エヌエヌダブリュー
No	ノー
NO	ノー
no.	ナンバー
No.	ナンバー
NO.	ナンバー
NOAA	ノア
NOC	エヌオーシー
NOFX	ノーエフエックス
NOK	エヌオーケイ
NOKKO	ノッコ
NOL	エヌオーエル
NOMO	ノモ
No−Mu−BA−RA	ノムバラ
NOMURA	ノムラ
non	ノン
Non	ノン
NON	ノン
NOR	エヌオーアール
NORAD	ノラド
Norderney	ノルダーナイ
Norihiro	ノリヒロ
Norimo	ノリモ
normal	ノーマル
NORMAL	ノーマル
Norton	ノートン
nose	ノーズ
not	ノット
NOT	ノット
NOTAM	ノータム
note	ノート
Note	ノート
Nothing	ナッシング
nova	ノバ
NOVA	ノバ
Novartis	ノバルティス
now	ナウ
Now	ナウ
NOW	ナウ
NOWPAP	エヌオーダブリューピーエーピー
NOWPHAS	エヌオーダブリューピーエイチエイエス
NOx	エヌオーエックス
NOX	エヌオーエックス
NPA	エヌピーエー
NPC	エヌピーシー
Npe	エヌピーイー
NPE	エヌピーイー
NPO	エヌピーオー
NPP	エヌピーピー
NPT	エヌピーティー
NRA	エヌアールエイ
NRC	エヌアールシー
NRL	エヌアールエル
NRM	エヌアールエム
NRP	エヌアールピー
ns	ナノセカンド
NS	エヌエス
NSA	エヌエスエー
NSB	エヌエスビー
NSC	エヌエスシー
NSF	エヌエスエフ
NSG	エヌエスジー
NSI	エヌエスアイ
NSP	エヌエスピー
NSR	エヌエスアール
NSRR	エヌエスアールアール
NSSR	エヌエスエスアール
NSTC	エヌエスティーシー
NSU	エヌエスユー
NSW	エヌエスダブリュー
NSWG	エヌエスダブリュージー
NT	エヌティー
NTCIR	エンティサイル
NTFS	エヌティーエフエス
NTIA	エヌティーアイエー
NTN	エヌティーエヌ
NTS	エヌティーエス
NTSB	エヌティーエスビー
NTT	エヌティーティー
NTV	ネヌティーブイ
NTWD	エヌティーダブリューディー
NUA	エヌユーエー
NUCEF	エヌユーシーイーエフ
Nuclear	ニュークリア
Num	ナム
number	ナンバー
NUMBER	ナンバー
NumLk	ナムエルケー
NUMLK	ナムエルケー
NUMMI	ヌミ
NUSS	エヌユーエスエス
NUSSAC	エヌユーエスエスエーシー
NV	エヌブイ
NVIDIA	エヌビディア
NW	エヌダブリュー
NY	ニューヨーク
NYC	ニューヨークシティ
NYMEX	エヌワイエムイーエックス
nymphea	ナンフェア
NZ	エヌゼット
o‐	オルト
O157	オーイチゴーナナ
OA	オーエイ
OAKLEY	オークリー
天満橋OAPタワー	テンマバシオーエーピータワー
OAPEC	オアペック
OAS	オーエイエス
OAU	オーエイユー
Oaxaca	オアハカ
OB	オービー
OBJ	オブジェ
object	オブジェクト
Object	オブジェクト
Obligation	オブリゲーション
OCA	オーシーエイ
ocean	オーシャン
Ocean	オーシャン
OCHA	オーシーエイチエイ
OCR	オーシーアール
October	オクトーバー
ODA	オーディーエー
ODIHR	オーディーアイエイチアール
OECD	オーイーシーディー
OECF	オーイーシーエフ
OEM	オーイーエム
Oenothera	オエノセラ
of	オブ
OF	オブ
OFC	オーエフシー
OFCF	オーエフシーエフ
OFDA	オーエフディーエー
OFDM	オーエフディーエム
off	オフ
OFF	オフ
office	オフィス
Office	オフィス
OFFICE	オフィス
Officer	オフィサー
OG	オージー
Ogawa	オガワ
OGF	オージーエフ
OGI	オージーアイ
OGJ	オージージェー
OGL	オージーエル
OGPU	オーゲーペーウー
OH	オーエイチ
OHC	オーエイチシー
OHP	オーエイチピー
OHQ	オーエイチキュー
OHSUMED	オースメッド
OHYAMA	オーヤマ
OIC	オーアイシー
OICETS	オーアイシーイーティーエス
OIE	オーアイイー
OIL	オイル
oinos	オイノス
OISCA	オイスカ
OJL	オージェーエル
OJT	オージェーティー
ok	オーケー
OK	オーケイ
OKAPI	オカピ
OKK	オーケイケイ
OL	オーエル
olanzapine	オランザピン
old	オールド
Old	オールド
OLS	オーエルエス
OLUHO	オーエルユーエイチオー
OLYMPUS	オリンパス
OM	オーエム
OMA	オーエムエー
OMC	オーエムシー
OMG	オーエムジー
omitted	オミテッド
OMT	オーエムティー
on	オン
On	オン
ON	オン
one	ワン
One	ワン
ONE	ワン
ONE PIECE	ワンピース
OneDrive	ワンドライブ
OneNote	ワンノート
ONION	オニオン
Online	オンライン
only	オンリー
Only	オンリー
ONLY	オンリー
ONUMOZ	オーエヌユーエムオーゼット
ONUSAL	オーエヌユーエスエーエル
ONUVEN	オーエヌユーブイイーエヌ
OOF	オーオーエフ
Oonishi	オーニシ
OP	オーピー
OPA	オーパ
OPAC	オーパック
OPCW	オーピーシーダブリュー
OPEC	オペック
open	オープン
Open	オープン
OPEN	オープン
open jtalk	オープンジェートーク
Open JTalk	オープンジェートーク
OPEN JTALK	オープンジェートーク
open_jtalk	オープンジェートーク
Open_JTalk	オープンジェートーク
OPEN_JTALK	オープンジェートーク
openjtalk	オープンジェートーク
OpenJTalk	オープンジェートーク
OPENJTALK	オープンジェートーク
opera	オペラ
Opera	オペラ
Operation	オペレーション
OPERATION	オペレーション
Operations	オペレーションズ
Operator	オペレーター
OPGW	オーピージーダブリュー
OPI	オーピーアイ
opinion	オピニオン
Opinion	オピニオン
OPINION	オピニオン
OPO	オーピーオー
OPRC	オーピーアールシー
Opt	オプト
Optimistic	オプティミスティック
option	オプション
Options	オプションズ
or	オア
OR	オーアール
Oracle	オラクル
Orange	オレンジ
Orb	オーブ
ORB	オーアールビー
Orban	オルバーン
ORBIT	オービット
order	オーダー
Order	オーダー
OREX	オーアールイーエックス
ORF	オーアールエフ
org	オーアールジー
ORG	オーアールジー
Organization	オーガニゼーション
ORHA	オーアールエイチエイ
origin	オリジン
ORR	オーアールアール
ORSR	オーアールエスアール
Orthogonal	オーサガナル
O′s	オズ
OS	オーエス
osaka	オーサカ
OSAKA	オーサカ
Osamu	オサム
OSART	オーエスエーアールティー
OSB	オーエスビー
OSC	オーエスシー
OSCE	オーエスシーイー
OSG	オーエスジー
OSI	オーエスアイ
OSPAR	オーエスピーエーアール
OST	オーエスティー
OT	オーティー
OTACK	オタック
Otani	オータニ
OTC	オーティーシー
OTO	オト
OTP	オーティーピー
our	アワー
OURD	オーユーアールディー
out	アウト
Out	アウト
OUT	アウト
Outline	アウトライン
Outlook	アウトルック
outreach	アウトリーチ
OVA	オーブイエー
over	オーバー
Over	オーバー
OVIS	オーブイアイエス
OVL	オーブイエル
OWNER	オーナー
Oxford	オックスフォード
OZ	オーゼット
OZONE	オゾン
p‐	パラ
P	ピー
P.M.	ピーエム
P&G	ピーアンドジー
P&O	ピーアンドオー
P&OCL	ピーアンドオーシーエル
pa	パスカル
Pa	パスカル
PA	ピーエイ
PAC	ピーエイシー
PACE	パーチェ
Pachon	パッション
Pacific	パシフィック
Pack	パック
Packet	パケット
pad	パッド
Pad	パッド
PAD	ピーエーディー
PADI	パディ
page	ページ
Page	ページ
PAGE	ページ
Pages	ページーズ
PAHO	ピーエイエイチオー
PAIGC	ピーエーアイジーシー
PALS	パルズ
PAM	パム
PAMELA	パメラ
pan	パン
Panasonic	パナソニック
panic	パニック
pans	パンズ
PANTOMIME	パントマイム
PAO	パオ
PAP	ピーエーピー
paper	ペーパー
Paper	ペーパー
PAPI	ピーエーピーアイ
Paradise	パラダイス
PARC	パーク
PARCO	パルコ
Paris	パリ
Park	パーク
PARK	パーク
Parker	パーカー
part	パート
Part	パート
PART	パート
party	パーティー
PARTY	パーティー
PAS	ピーエーエス
PASC	ピーエイエスシー
Pascal	パスカル
PASOK	ピーエーエスオーケー
Passage	パッセージ
Passion	パッション
PAST	パースト
Pasteur	パスツール
PATA	ピーエーティーエー
path	パス
pathos	ペーソス
PATOLIS	パトリス
Patrick	パトリック
Paul	ポール
Paula	ポーラ
PAXビル	パックスビル
PAY	ペイ
Pb	ピービー
PB	ピービー
PBA	ピービーエー
PBF	ピービーエフ
PBS	ピービーエス
PBX	ピービーエックス
pc	ピーシー
PC	ピーシー
PCA	ピーシーエー
PCAST	ピーシーエーエスティー
PC−AT	ピーシーエーティー
PCB	ピーシービー
PCBs	ピーシービーエス
PCCW	ピーシーシーダブリュー
PCDD	ピーシーディーディー
PCDF	ピーシーディーエフ
PCFG	ピーシーエフジー
PCI	ピーシーアイ
PCM	ピーシーエム
PCN	ピーシーエヌ
PCP	ピーシーピー
PCR	ピーシーアール
PCS	ピーシーエス
PCSP	ピーシーエスピー
PCT	ピーシーティー
PC—VAN	ピーシーバン
Pd	ピーディー
PD	ピーディー
PDA	ピーディーエー
PDC	ピーディーシー
PDD	ピーディーディー
PDF	ピーディーエフ
PDG	ピーディージー
PDS	ピーディーエス
PDT	ピーディーティー
Peace	ピース
PEACE	ピース
Pearsall	ピアサル
PEAT	ピーイーエーティー
PEC	ピーイーシー
PECC	ペック
Peer	ピアー
PEG	ピーイージー
pen	ペン
PEN	ペン
Pensieve	ペンシーブ
Pentium	ペンティアム
people	ピープル
People	ピープル
PER	ピーイーアール
Percentage	パーセンテージ
perfect	パーフェクト
Perfect	パーフェクト
PERFECT	パーフェクト
performance	パフォーマンス
Performance	パフォーマンス
PERFORMIX	パフォーミックス
Perfume	パフューム
perl	パール
Perl	パール
PERL	パール
permanent	パーマネント
person	パーソン
Person	パーソン
personal	パーソナル
Personal	パーソナル
Perspective	パースペクティブ
PERSPECTIVE	パースペクティブ
Pessimistic	ペシミスティック
PET	ピーイーティー
peter	ペーター
Peter	ピーター
petit	プチ
PEX	ピーイーエックス
PF	ピーエフ
PFC	ピーエフシー
PFI	ピーエフアイ
PFLP	ピーエフエルピー
PFP	ピーエフピー
PFR	ピーエフアール
PFT	ピーエフティー
PFU	ピーエフユー
pg	ピコグラム
PG	ピージー
PG&E	ピージーアンドイー
PGG	ピージージー
PGM	ピージーエム
pH	ペーハー
PH	ペーハー
Ph.D.	ピーエイチディー
Pharmaceuticals	ファーマスーティカルズ
Pharmacia	ファーマシア
Pharmacyclics	ファーマサイクリクス
PHC	ピーエイチシー
PhD	ピーエイチディー
PHD	ピーエイチディー
PHEBUS	ピーエイチイービーユーエス
PHIA	ピーエイチアイエイ
Philippine	フィリピン
Phisical	フィジカル
PHMM	ピーエイチエムエム
phone	フォーン
Phone	フォン
PHONO	フォノ
photo	フォト
Photo	フォト
PHOTO	フォト
Photodynamic	フォトダイナミク
Photograph	フォトグラフ
photographs	フォトグラフス
Photos	フォトス
PHP	ピーエイチピー
phrasing	フレージング
PHS	ピーエイチエス
PHW	ピーエイチダブリュー
PHY	ピーエイチワイ
pia	ピーアイエー
PIA	ピーアイエー
PIAFS	ピーアイエーエフエス
Piano	ピアノ
pianos	ピアノズ
PIC	ピーアイシー
PiCNiC	ピクニック
PICOLA	ピコラ
Picture	ピクチャー
Pictures	ピクチャーズ
PICTURES	ピクチャーズ
picturesque	ピクチャレスク
Piece	ピース
Pierre	ピエール
Pigeon	ピジョン
PIK	ピーアイケー
PILOT	パイロット
PINEAPPLE	パイナップル
Pine’s	パインズ
Pink	ピンク
Pinker	ピンカー
Pinterest	ピンタレスト
PIO	ピーアイオー
PIP	ピーアイピー
PISA	ピーアイエスエー
PISC	ピーアイエスシー
PISCES	ピスケス
pitch	ピッチ
Pittards	ピタード
PIW	ピーアイダブリュー
Pixar	ピクサー
PJBD	ピージェービーディー
PJM	ピージェイエム
PK	ピーケイ
PKF	ピーケイエフ
PKO	ピーケイオー
PL	ピーエル
place	プレース
Place	プレース
Plan	プラン
PLAN	プラン
Planet	プラネット
PLANET	プラネット
Platon	プラトン
play	プレー
Play	プレー
Play Station	プレイステーション
Playboy	プレーボーイ
Player	プレーヤー
PlayStation	プレイステーション
Plaza	プラザ
PLC	ピーエルシー
PLD	ピーエルディー
please	プリーズ
Please	プリーズ
Pleasure	プレジャー
PLO	ピーエルオー
plot	プロット
PLP	ピーエルピー
PLSD	ピーエルエスディー
plus	プラス
Plus	プラス
PLUS	プラス
pm	ピーエム
Pm	ピーエム
PM	ピーエム
PMC	ピーエムシー
PMF	ピーエムエフ
ハイデルベルグPMT	ハイデルベルグピーエムティー
PNC	ピーエヌシー
png	ピーエヌジー
PNG	ピーエヌジー
PNP	ピーエヌピー
PNS	ピーエヌエス
POC	ポック
POCARI	ポカリ
Pocket	ポケット
Pod	ポッド
Poemix	ポエミックス
Poetry	ポエトリー
POG	ピーオージー
point	ポイント
Point	ポイント
POINT	ポイント
POLA	ポーラ
Polaris	ポラリス
Policy	ポリシー
Politica	ポリティカ
Political	ポリティカル
pooh	プー
Poor	プアー
pop	ポップ
POP	ポップ
Pope	ポープ
POPs	ピーオーピーエス
Popular	ポピュラー
Population	ポピュレーション
Port	ポート
Portable	ポータブル
portfolio	ポートフォリオ
PORTMAN	ポートマン
POS	ポス
POSA	ポサ
positive	ポジティブ
possible	ポッシブル
Post	ポスト
Posted	ポステッド
pot	ポット
POTSHOT	ポットショット
power	パワー
Power	パワー
POWER	パワー
PowerPoint	パワーポイント
PP	ピーピー
ppb	ピーピービー
ppm	ピーピーエム
PPM	ピーピーエム
ppmC	ピーピーエムシー
ppmv	ピーピーエムブイ
PPP	ピーピーピー
PPPoE	ピーピーピーオーイー
ppt	ピーピーティー
PR	ピーアール
Practice	プラクティス
PRAYER	プレーヤー
PRD	ピーアールディー
pre	プレ
precious	プレシャス
PreF	ピーアールイーエフ
Preferences	プレファレンス
Premiere	プレミア
Premium	プレミアム
presence	プレゼンス
PRESENT	プレゼント
PresentA	プレゼンタ
President	プレジデント
Press	プレス
pretty	プリティー
PRI	ピーアールアイ
price	プライス
prices	プライセス
pride	プライド
PRIDE	プライド
Primary	プライマリー
primrose	プリムローズ
print	プリント
Print	プリント
PRINT	プリント
Pro	プロ
PRO	プロ
Probe	プローブ
Probiotics	プロバイオティクス
problem	プロブレム
Problem	プロブレム
process	プロセス
product	プロダクト
Product	プロダクト
production	プロダクション
Professional	プロフェッショナル
profile	プロフィール
Profile	プロフィール
PROFILE	プロフィール
PROGOL	プロゴル
program	プログラム
Program	プログラム
Programs	プログラムス
progress	プログレス
Progress	プログレス
Progressive	プログレッシブ
Prohibition	プロヒビション
project	プロジェクト
Project	プロジェクト
PROJECT	プロジェクト
Projection	プロジェクション
proliferation	プロリフェレーション
Proliferation	プロリフェレーション
PROLOG	プロログ
promise	プロミス
Property	プロパティー
Protection	プロテクション
protein	プロテイン
protocol	プロトコル
Protocol	プロトコル
PRS	ピーアールエス
PRSC	ピーアールエスシー
PRSP	ピーアールエスピー
PRT	ピーアールティー
PRTR	ピーアールティーアール
PS	ピーエス
PS2	ピーエスツー
PS3	ピーエススリー
PS4	ピーエスフォー
PSA	ピーエスエー
PSBayu	ペーエスバユ
PSC	ピーエスシー
PSE	ピーエスイー
PSh	ピーエスエイチ
PSI	ピーエスアイ
PSI−CELP	プサイセルプ
PSM	ピーエスエム
PSOLA	ピーソーラ
PSP	ピーエスピー
PSPS	ピーエスピーエス
PSV	ピーエスブイ
PSYCHE	プシュケ
Pt	ピーティー
PT	ピーティー
PTA	ピーティーエー
PTB	ピーティービー
PTM	ピーティーエム
PTN	ピーティーエヌ
PTPS	ピーティーピーエス
PTS	ピーティーエス
PTSD	ピーティーエスディー
public	パブリック
Public	パブリック
Publisher	パブリッシャー
Publishing	パブリッシング
Punch	パンチ
PUP	ピーユーピー
PURE	ピュア
Purlytin	プルリチン
Purple	パープル
put	プット
PV	ピーブイ
PVA	ピーブイエー
PVC	ピーブイシー
PVM	ピーブイエム
PW	ピーダブリュー
PWC	ピーダブリューシー
PWG	ピーダブリュージー
PWM	ピーダブリューエム
PWR	ピーダブリューアール
PZT	ピーゼットティー
Q太	キュータ
Q&A	キューアンドエー
Q2	キューツー
QアンドA	キューアンドエイ
QAM	キューエーエム
QB	キュービー
QC	キューシー
QDR	キューディーアール
QED	キューイーディー
QJ	キュージェー
QL	キューエル
QOL	キューオーエル
QoS	キューオーエス
QRコード	キューアールコード
QRV	キューアールブイ
QS	キューエス
QSS	キューエスエス
Qualcomm	クアルコム
Quality	クオリティー
Que	キュー
Queen	クイーン
Query	クエリー
question	クエスチョン
QUESTION	クエスチョン
Questions	クエスチョンズ
Quick	クイック
QURACIO	キュラソー
Quran	コーラン
R	アール
R&Dプラザ	アールアンドディープラザ
R&R	ロックンロール
R12	アールイチニ
Ra	アールエー
RA	アールエー
rac	ラック
RAC	ラック
Rachel	レイチェル
rad	ラジアン
rad/s	ラジアンマイビョー
Radcliffe	ラドクリフ
Radeon	ラデオン
RADEON	ラデオン
Radio	ラジオ
RADIO	ラジオ
RADWASS	アールエーディーダブリューエーエスエス
RAE	レイ
RAI	アールエイアイ
RAID	レード
Rail	レール
rain	レーン
Rain	レーン
RAIN	レーン
RAM	アールエーエム
RaMIOS	ラミオス
random	ランダム
Random	ランダム
RANDOM	ランダム
RANK	ランク
RAPCON	ラプコン
rapport	ラポール
RAS	アールエーエス
RASD	アールエーエスディー
RASS	アールエーエスエス
RASSAC	アールエーエスエスエーシー
RASTA	ラスタ
rate	レート
Rate	レート
rational	ラショナル
RAW	アールエーダブリュー
RAYMOND	レイモンド
RB	アールビー
RBMK	アールビーエムケー
RBP	アールビーピー
RC	アールシー
RCA	アールシーエー
RCAG	アールシーエージー
RCC	アールシーシー
RCMP	アールシーエムピー
RCZ	アールシーゼット
RD	アールディー
RDB	アールディービー
RDBMS	アールディービーエムエス
RDF	アールディーエフ
RDM	アールディーエム
RDN	アールディーエヌ
RDP	アールディーピー
RDR	アールディーアール
RDX	アールディーエックス
RE	アールイー
reach	リーチ
read	リード
Read	リード
ReaD	アールイーエーディー
READ	アールイーエーディー
Reader	リーダー
Readers	リーダーズ
READERS	リーダーズ
Real	リアル
REAL	リアル
reality	リアリティー
Realtime	リアルタイム
re—birth	リバース
REBO	アールイービーオー
REC	レック
receive	レシーブ
recipe	レシピ
Record	レコード
Recorder	レコーダー
recover	リカバー
RECYCLER	リサイクラー
Red	レッド
reference	レファレンス
Reform	リフォーム
refresh	リフレッシュ
Regalo	レガロ
Regime	レジーム
Regional	リージョナル
register	レジスター
regular	レギュラー
REGZA	レグザ
rehabilitation	リハビリテーション
Rehabilitation	リハビリテーション
REIKO	レイコ
REIT	リート
rejuna	レユーナ
Relations	リレーションズ
relay	リレー
release	リリース
Release	リリース
REM	アールイーエム
REMIX	リミックス
remove	リムーブ
RENS	アールイーエヌエス
repeat	リピート
repeater	リピーター
replace	リプレース
Report	レポート
REPORT	レポート
require	リクワイアー
Research	リサーチ
Researcher	リサーチャー
reservation	リザベーション
Reserve	リザーブ
Rest	レスト
Re‐Style	リスタイル
retail	リテール
Return	リターン
Review	レビュー
revolution	レボリューション
Revolution	レボリューション
Revue	レビュー
REX	レックス
RF	アールエフ
RFC	アールエフシー
RFFG	アールエフエフジー
RFID	アールエフアイディー
RFLG	アールエフエルジー
RFTI	アールエフティーアイ
RG	アールジー
RGB	アールジービー
Rh	アールエイチ
RH	アールエイチ
Rhodes	ローズ
rhyme	ライム
rhythm	リズム
RI	アールアイ
RIA	アールアイエー
RIBA	アールアイビーエイ
Richard	リチャード
RICK	リック
RIFCDP	アールアイエフシーディーピー
right	ライト
Right	ライト
RIHGA	リーガ
RIM	アールアイエム
RIMPAC	リムパック
Ring	リング
RISC	リスク
Rishikesa	リシュケーシャ
risk	リスク
Risk	リスク
RISTORANTE	リストランテ
RITM	アールアイティーエム
RITZ	リッツ
River	リバー
RKB	アールケイビー
RLS	アールエルエス
RMA	アールエムエイ
RMK	アールエムケー
RMS	アールエムエス
RMSEA	アールエムシー
Rn	アールエヌ
RN	アールエヌ
RNA	アールエヌエイ
RNAV	アールエヌエーブイ
RO/RO	ローロー
Robert	ロバート
ROBOT	ロボット
ROC	アールオーシー
Rock	ロック
ROCK	ロック
Rogers	ロジャース
RoHS	アールオーエイチエス
ROHS	アールオーエイチエス
role	ロール
Role	ロール
Roll	ロール
ROM	ロム
Romano	ロマーノ
Ronald	ロナルド
Rondo	ロンド
roof	ルーフ
ROOM	ルーム
root	ルート
roro	ロロ
RORO	ローロー
ROSA	アールオーエスエー
Rose	ローズ
rotary	ロータリー
Round	ラウンド
route	ルート
ROUTE	ルート
ROVER	ローバー
Royal	ロイヤル
ROYAL	ロイヤル
RPF	アールピーエフ
RPG	アールピージー
RPP	アールピーピー
RPR	アールピーアール
RPS	アールピーエス
RPT	アールピーティー
RPzB	アールピーゼットビー
RPZB	アールピーゼットビー
RQ	アールキュー
RR	アールアール
RSA	アールエスエー
RSC	アールエスシー
RSE	アールエスイー
RSM	アールエスエム
RSP	アールエスピー
RSS	アールエスエス
RST	アールエスティー
RT	アールティー
RTC	アールティーシー
RTK	アールティーケー
RTL	アールティーエル
RTNS	アールティーエヌエス
RTP	アールティーピー
RTS	アールティーエス
RTT	アールティーティー
ru	アールユー
RU	アールユー
Rudolf	ルドルフ
rule	ルール
Rule	ルール
RUMIKO	ルミコ
run	ラン
RUN	ラン
RUSHIRU’S	ルシルズ
Rutberg	ラトバーグ
RV	アールブイ
RV4	アールブイフォー
RVSM	アールブイエスエム
RW	アールダブリュー
RWC	アールダブリューシー
RWCP	アールダブリューシーピー
RWE	アールダブリューイー
RWMC	アールダブリューエムシー
RWR	アールダブリューアール
RX	アールエックス
RX—7・GTS	アールエックスセブンジーティーエス
Ryo	リョー
Ryzen	ライゼン
s	セカンド
S子	エスコ
S.A.S.	エスエーエス
S&B	エスビー
S&G	サイモンアンドガーファンクル
S&W	エスアンドダブリュー
SA	エスエイ
SAARC	サーク
Saburo	サブロー
SACO	エスエーシーオー
sad	サッド
Sadahiro	サダヒロ
Sadako	サダコ
SADCC	エスエーディーシーシー
SAF	エスエーエフ
safety	セーフティー
Safety	セーフティー
SAGE	セージ
SAGITTARIUS	サジタリウス
Sagnier	サニエ
SAGURI	サグリ
SAJ	エスエージェー
SAKAI	サカイ
sakakibara	サカキバラ
Sakakibara	サカキバラ
Sakamoto	サカモト
SAKURA	サクラ
SAL	エスエーエル
SALE	セール
sales	セールス
Salkovskis	サルコフスキス
Salmasi	サルマシ
SALT	ソルト
SAM	サム
same	セイム
SAMPA	サンパ
SAMPLE	サンプル
Samsung	サムスン
SAMSUNG	サムスン
Samuel	サミュエル
SANKYO	サンキョー
Santa	サンタ
Santa Barbara	サンタバーバラ
Santo Domingo	サントドミンゴ
SAP	エスエーピー
SAPI	サピ
Sapphire	サファイア
SAPPORO	サッポロ
SAR	エスエーアール
SARS	サーズ
SAS	エスエーエス
SASEBO	サセボ
SAT	サット
SATAN	サタン
SATC	エスエーティーシー
SATPOS	エスエーティーピーオーエス
SAUCE	ソース
Savannah	サバンナ
Savigny	サビニー
SAW	ソー
SAWAMOTO	サワモト
say	セイ
Sb	エスビー
SB	エスビー
SBA	エスビーエイ
SBF	エスビーエフ
SBI	エスビーアイ
SBK	エスビーケー
SBS	エスビーエス
SBT	エスビーティー
SC	エスシー
SCA	エスシーエー
scale	スケール
Scale	スケール
SCALETTA	スカレッタ
Scan	スキャン
SCANNER	スキャナー
scape	スケープ
scapegoats	スケープゴート
SCAPIN	スキャッピン
SCB	エスシービー
SCC	エスシーシー
scene	シーン
Scene	シーン
SCFG	エスシーエフジー
Schaake	シャーケ
Schedule	スケジュール
Schmidt	シュミット
schokolade	ショコラーデ
Scholes	ショールズ
school	スクール
School	スクール
SCI	エスシーアイ
science	サイエンス
Science	サイエンス
scientific	サイエンティフィック
Scientific	サイエンティフィック
Scientists	サイエンティスツ
SCIRI	エスシーアイアールアイ
SCM	エスシーエム
Score	スコア
SCORPIO	スコーピオ
Scott	スコット
SCPC	エスシーピーシー
Script	スクリプト
SD	エスディー
SDA	エスディーエー
SDAB	エスディーエービー
SDC	エスディーシー
SDI	エスディーアイ
SDML	エスディーエムエル
SDR	エスディーアール
SDS	エスディーエス
SE	エスイー
Sea	シー
SEAFDEC	エスイーエーエフディーイーシー
SEAPCENTRE	エスイーエーピーシーイーエヌティーアールイー
Search	サーチ
Searle	サール
SEATAC	エスイーエーティーエーシー
SEATO	シアトー
Seberg	セバーグ
sec	セック
SEC	エスイーシー
SECOJ	エスイーシーオージェー
second	セカンド
Second	セカンド
SECOND	セカンド
secret	シークレット
Secretary	セクレタリー
Sect	セクト
section	セクション
Section	セクション
SECTION	セクション
Secure	セキュア
security	セキュリティー
Security	セキュリティー
sed	エスイーディー
seD	エスイーディー
SED	セッド
see	スィー
SEE	スィー
SEEING	シーイング
Seen	シーン
SEFOR	エスイーエフオーアール
SEIKO	セイコー
SEKIZUKA	セキズカ
SELA	セラ
Select	セレクト
Selected	セレクテッド
SELENE	エスイーエルイーエヌイー
self	セルフ
Self	セルフ
SEM	エスイーエム
SEMATECH	セマテック
sense	センス
Sense	センス
Sensitive	センシティブ
SENSITIVE	センシティブ
sentence	センテンス
Sentence	センテンス
SEO	エスイーオー
SEP	エスイーピー
separate	セパレート
September	セプテンバー
sequence	シークエンス
Sequence	シークエンス
SERENA	エスイーアールイーエヌエー
serious	シリアス
Serra	セラ
SERVE	サーブ
server	サーバー
Server	サーバー
Service	サービス
SERVIS	エスイーアールブイアイエス
SESS	エスイーエスエス
session	セッション
Session	セッション
set	セット
SETI	セティ
setter	セッター
Setup	セットアップ
SEVENTEEN	セブンティーン
Sewell	シーウェル
sex	セックス
SEX	セックス
SF	エスエフ
SFC	エスエフシー
SFD	エスエフディー
SFG	エスエフジー
SFJ	エスエフジェー
SFOR	エスエフオーアール
SFX	エスエフエックス
SG	エスジー
SGATAR	エスジーエーティーエーアール
SGI	エスジーアイ
SGML	エスジーエムエル
SH	エスエイチ
SHANGHAI	シャンハイ
shape	シェープ
Share	シェア
Shared	シェアード
SharePoint	シェアポイント
SHARES	シェアーズ
Sharon	シャロン
She	シー
SHE	エスエイチイー
Sheet	シート
SHELTER	シェルター
SHF	エスエイチエフ
shibuya	シブヤ
SHIBUYA	シブヤ
shift	シフト
Shift	シフト
Shiga	シガ
Shigeru	シゲル
Shimada	シマダ
Shimosoyama	シモソヤマ
SHINPO	シンポ
ship	シップ
Ship	シップ
Shipping	シッピング
Shiraya	シラヤ
SHIZUKI	シズキ
Shocking	ショッキング
Shoes	シューズ
Shogo	ショーゴ
Shooting	シューティング
shop	ショップ
Shop	ショップ
SHOP	ショップ
short	ショート
should	シュッド
show	ショー
SHOW	ショー
shower	シャワー
Shrink	シュリンク
shy	シャイ
Si	エスアイ
SI	エスアイ
Siberia	シベリア
SICA	エスアイシーエー
sich	ジヒ
side	サイド
SIDE	サイド
SIDS	エスアイディーエス
Sierra	シエラ
SII	エスアイアイ
Simon	サイモン
simple	シンプル
Simple	シンプル
sin	サイン
SINET	エスアイエヌイーティー
SING	シング
Singing	シンギング
sink	シンク
SINK	シンク
sinsy	シンシー
Sinsy	シンシー
SINSY	シンシー
SIPRI	シプリ
SIS	エスアイエス
SIT	エスアイティー
SITC	エスアイティーシー
site	サイト
SITE	サイト
SIV	エスアイブイ
size	サイズ
SJハウス	エスジェイハウス
SJF	エスジェーエフ
SKA	スカ
SKBF	エスケービーエフ
SKD	エスケーディー
Skin	スキン
SKIN	スキン
Skoop	スクープ
SKY	スカイ
Skype	スカイプ
SL	エスエル
SLA	エスエルエー
SLAC	エスエルエーシー
SLAPI	スラッピー
Slave	スレーブ
SLBM	エスエルビーエム
SLCM	エスエルシーエム
sleep	スリープ
SLM	エスエルエム
SLORC	エスエルオーアールシー
slow	スロー
SLP	エスエルピー
SLUNG	スラング
SM	エスエム
Small	スモール
SMAM	エスエムエーエム
SMAP	スマップ
Smart	スマート
SMART	スマート
SMC	エスエムシー
SMEs	エスエムイーエス
SMG	エスエムジー
Smith	スミス
SMK	エスエムケイ
SML	エスエムエル
Smoke	スモーク
SMON	スモン
SMR	エスエムアール
SMS	エスエムエス
smtp	エスエムティーピー
SMTP	エスエムティーピー
SMX	エスエムエックス
SN	エスエヌ
SNA	エスエヌエー
SNC	エスエヌシー
SnET	エスエヌイーティー
SNF	エスエヌエフ
SNG	エスエヌジー
SNM	エスエヌエム
Snow	スノー
SNR	エスエヌアール
SNS	エスエヌエス
so	ソー
SO	エスオー
SOA	エスオーエー
soap	ソープ
social	ソーシャル
Social	ソーシャル
society	ソサエティー
Society	ソサエティー
SOD	エスオーディー
SOF	エスオーエフ
SOFIREM	エスオーエフアイアールイーエム
SOFRES	エスオーエフアールイーエス
soft	ソフト
SoftBank	ソフトバンク
Software	ソフトウェア
SOGO	ソゴー
SOHO	ソーホー
SOI	エスオーアイ
SOLAR	エスオーエルエーアール
SOLAS	エスオーエルエーエス
Solutions	ソリューションズ
Solzhenitsyn	ソルジェニーツィン
SOM	サム
Somalia	ソマリア
Somebody	サムバディー
something	サムシング
sonar	ソナー
SONIA	ソニア
SONIC	ソニック
SONNY	サニー
SONUS	ソヌス
sony	ソニー
Sony	ソニー
SONY	ソニー
soon	スーン
SOON	スーン
SOPAC	エスオーピーエーシー
sorry	ソーリー
SOS	エスオーエス
Soul	ソール
SOUL’d	ソールド
sound	サウンド
Sound	サウンド
South	サウス
Southern	サザン
SOx	エスオーエックス
SOX	エスオーエックス
SP	エスピー
SpA	エスピーエー
SPA	エスピーエー
space	スペース
Space	スペース
SPACE	スペース
Spam	スパム
SPAM	スパム
SPAN	スパン
SPC	エスピーシー
東京SPDセンター	トーキョーエスピーディーセンター
SPDC	エスピーディーシー
SPE	エスピーイー
speak	スピーク
SPEAKS	スピークス
spec	スペック
special	スペシャル
Special	スペシャル
SPECIAL	スペシャル
speciosa	スペキオサ
SPECT	スペクト
speed	スピード
SPEED	スピード
SPEEDI	エスピーイーイーディーアイ
SPENCER	スペンサー
SPF	エスピーエフ
Spice	スパイス
spider	スパイダー
spin	スピン
Spirit	スピリット
SPK	エスピーケイ
SPLA	エスピーエルエー
SPLM	エスピーエルエム
SPM	エスピーエム
SPN	エスピーエヌ
SpO	エスピーオー
Sportiv	スポーティブ
Sports	スポーツ
SPORTS	スポーツ
SPOT	スポット
SPREP	エスピーアールイーピー
spring	スプリング
Spring	スプリング
SPring	スプリング
SPring—8	スプリングエイト
Springfield	スプリングフィールド
Sprint	スプリント
SPSE	エスピーエスイー
SPSS	エスピーエスエス
SPTK	エスピーティーケー
SPU	エスピーユー
Spur	シュプール
SPW	エスピーダブリュー
SPY	スパイ
SQ	エスキュー
SQL	エスキューエル
square	スクエア
SQUARE	スクエア
Sr	エスアール
SR	エスアール
SRA	エスアールエイ
SRAM	エスアールエーエム
SRC	エスアールシー
SRF	エスアールエフ
SRI	エスアールアイ
SRRC	エスアールアールシー
SRY	エスアールワイ
SS	エスエス
中央SS30住友生命仙台中央ビル	チューオーエスエスサンジュースミトモセーメーセンダイチューオービル
SSB	エスエスビー
SSBN	エスエスビーエヌ
SSC	エスエスシー
SSD	エスエスディー
SSEB	エスエスイービー
SSI	エスエスアイ
SSL	エスエスエル
SSLG	エスエスエルジー
SSM	エスエスエム
SSN	エスエスエヌ
SSR	エスエスアール
SSRA	エスエスアールエー
SSS	エスエスエス
SST	エスエスティー
SSTV	エスエスティーブイ
st	ショートトン
ST	エスティー
STA	エスティーエー
staff	スタッフ
Staff	スタッフ
STAFF	スタッフ
stage	ステージ
Stage	ステージ
STAI	エスティーエーアイ
STAMP	スタンプ
STAN	エスティーエーエヌ
stand	スタンド
standard	スタンダード
Standby	スタンバイ
standing	スタンディング
Star	スター
STAR	スター
STARS	スターズ
start	スタート
Start	スタート
STaRT	スタート
START	スタート
START2	スタートツー
Starting	スターティング
startups	スタートアップス
STAT	スタット
state	ステート
State	ステート
STATION	ステーション
STB	エスティービー
STC	エスティーシー
STCW	エスティーシーダブリュー
STD	エスティーディー
STDEVP	エスティーディーエーブイピー
Steel	スチール
Stendhal	スタンダール
Stent	ステント
step	ステップ
Step	ステップ
STEP	ステップ
Steven	スティーブン
STI	エスティーアイ
STI KINUTA	エスティーアイキヌタ
stick	スティック
Stithaprajna	スティタプラジニャ
STK	エスティーケー
STN	エスティーエヌ
STNet	エスティーネット
STNET	エスティーネット
stock	ストック
Stock	ストック
STOL	エストール
stone	ストーン
Stone	ストーン
Stop	ストップ
STOP	ストップ
storage	ストレージ
store	ストア
Store	ストア
Stories	ストーリーズ
Storm	ストーム
story	ストーリー
Story	ストーリー
STORY	ストーリー
STP	エスティーピー
str	エスティーアール
STR	エスティーアール
STRAIGHT	ストレート
Strange	ストレンジ
Strategic	ストラテジック
Strategy	ストラテジー
STRATEGY	ストラテジー
STRAW	ストロー
Street	ストリート
Strengths	ストレングスズ
strike	ストライク
string	ストリング
String	ストリング
Strobo	ストロボ
structure	ストラクチャー
Structure	ストラクチャー
Struts	ストラッツ
stU	ショートトンウラン
Stuart	スチュアート
Student	スチューデント
Studies	スタディーズ
studio	スタジオ
Studio	スタジオ
STUDIO	スタジオ
study	スタディー
Study	スタディー
STV	エスティーブイ
style	スタイル
Style	スタイル
STYLE	スタイル
SU	エスユー
SUB	サブ
SUBJ	サブジェ
subject	サブジェクト
Subject	サブジェクト
subset	サブセット
substance	サブスタンス
success	サクセス
Success	サクセス
SUCCESS	サクセス
スポーツランドSUGO	スポーツランドスゴー
Suica	スイカ
SUIFU	スイフ
SUIT	スーツ
Suite	スイート
SUKIYAKI	スキヤキ
Sullivan	サリバン
SUM	サム
SUMMAC	サンマック
Summary	サマリー
summer	サマー
Summer	サマー
SUMMER	サマー
SUN	サン
SUNDAE	サンデー
SUNDAY	サンデー
SUNTORY	サントリー
super	スーパー
Super	スーパー
SUPER	スーパー
supercalifragilisticexpialidocious	スーパーカリフラジリスティクエクスピアリドーシャス
Suppliers	サプライヤーズ
Supplies	サプライズ
supply	サプライ
Supply	サプライ
Support	サポート
Sur	スール
surplus	サープラス
surprise	サプライズ
SURPRISE	サプライズ
Survey	サーベイ
Susan	スーザン
SUV	エスユーブイ
Suzuki	スズキ
Sv	シーベルト
SV	エスブイ
SVA	エスブイエイ
SVD	エスブイディー
SVF	エスブイエフ
SVM	エスブイエム
SW	エスダブリュー
swab	スワブ
SWAN	スワン
SWAPO	スワポ
SWATi	スワティ
SWATI	スワティ
SWEAT	スウェット
Sweden	スウェーデン
SWEDEN	スウェーデン
Swedish	スウェディッシュ
sweep	スイープ
SWIFT	エスダブリューアイエフティー
Switch	スイッチ
SWU	エスダブリューユー
SX	エスエックス
SY	エスワイ
Symantec	シマンテック
Symphony	シンフォニー
SYMPHONY	シンフォニー
Sync	シンク
syndrome	シンドローム
Synthetic	シンセティック
system	システム
System	システム
SYSTEM	システム
t	トン
T子	ティーコ
T/C	トラベラーズチェック
T&K TOKA	ティーアンドケイトーカ
T&KTOKA	ティーアンドケイトーカ
T38	ティーサンハチ
T93	ティーキューサン
T94	ティーキューヨン
TA	ティーエー
TAB	タブ
Table	テーブル
TAC	ティーエーシー
TACAN	タカン
TACTICS	タクティクス
TADATOSHI	タダトシ
Tag	タグ
Taiko	タイコ
TAIS	ティーエーアイエス
TAKASHI	タカシ
TAKATA	タカタ
Take	テーク
TAKEO	タケオ
takes	テークス
talk	トーク
TANGOS	タンゴス
Tanner	タナー
TAO	タオ
TAONET	ティーエーオーエヌイーティー
TAP	ティーエーピー
Tashiro	タシロ
taspo	タスポ
TATSUYA	タツヤ
TAURUS	トーラス
Tax	タックス
Taylor	テイラー
TB	テラバイト
TBC	ティービーシー
TBL	ティービーエル
TBR	ティービーアール
TBS	ティービーエス
TBT	ティービーティー
tC	トンカーボン
Tc	ティーシー
TC	ティーシー
TCL	ティーシーエル
TCP	ティーシーピー
TCS	ティーシーエス
TCW	ティーシーダブリュー
TDB	ティーディービー
TDF	ティーディーエフ
TDH	ティーディーエイチ
TDK	ティーディーケイ
TDL	ティーディーエル
TDM	ティーディーエム
TDMA	ティーディーエムエー
TDMT	ティーディーエムティー
TDN	ティーディーエヌ
TDR	ティーディーアール
TDRSS	ティーディーアールエスエス
セコムTEセンター	セコムティーイーセンター
Tea	ティー
teacher	ティーチャー
Team	チーム
TEAM	チーム
TECH	テック
technique	テクニック
Techno Speech	テクノスピーチ
Technologies	テクノロジーズ
Technology	テクノロジー
Techno−Speech	テクノスピーチ
Teddy	テディー
tek	テック
TeK	テック
tel	テル
Tel	テル
TEL	テル
Telecommunication	テレコミュニケーション
telephone	テレホン
Telephony	テレフォニー
TEMAX	テマックス
TEMPO	テンポ
TEN	テン
Tenjin	テンジン
Teotiuacan	テオティワカン
TEPCO	テプコ
TEQ	ティーイーキュー
term	ターム
Term	ターム
Terminal	ターミナル
terms	タームス
terra	テラ
TERU	テル
Teruya	テルヤ
Teruyoshi	テルヨシ
TESOL	テッスル
test	テスト
Test	テスト
TEST	テスト
TEU	ティーイーユー
texaphyrin	テキサフィリン
text	テキスト
Text	テキスト
TEXT	テキスト
TEXTOR	ティーイーエックスティーオーアール
TF	ティーエフ
TFP	ティーエフピー
TFT	ティーエフティー
TFTR	ティーエフティーアール
TGMM	ティージーエムエム
TGV	ティージーブイ
TH	ティーエイチ
THAAD	ティーエイチエイエイディー
than	ザン
THANGAVELU	サンガベル
THANX	サンクス
that	ザット
the	ザ
The	ザ
THE	ザ
Theater	シアター
Theme	テーマ
theoretical	セオレティカル
theory	セオリー
Theory	セオリー
ther	セア
Therapy	セラピー
they	ゼイ
thicker	シッカー
think	シンク
Think	シンク
ThinkPad	シンクパッド
third	サード
Third	サード
THIRTY	サーティー
this	ディス
This	ディス
THIS	ディス
THK	ティーエイチケイ
Thomas	トーマス
Thompson	トンプソン
THORP	ティーエイチオーアールピー
thousand	サウザンド
Thread	スレッド
threat	スレット
three	スリー
Three	スリー
thriller	スリラー
THTR	ティーエイチティーアール
Thunderbolt	サンダーボルト
Thursday	サーズデー
THW	ティーエイチダブリュー
Ti	ティーアイ
TI	ティーアイ
TIC	ティーアイシー
TICAD	ティーアイシーエーディー
TIFF	ティーアイエフエフ
Tiger	タイガー
Tigers	タイガース
TIJ	ティーアイジェー
Tikal	ティカル
TIMAKI	チマキ
time	タイム
Time	タイム
TIME	タイム
times	タイムズ
TIMIT	ティミット
Tin	チン
TIPS	ティップス
TITLE	タイトル
TK	ティーケイ
TKC	ティーケイシー
TKO	ティーケイオー
TKR	ティーケイアール
TLC	ティーエルシー
tld	ティーエルディー
TLD	ティーエルディー
TLO	ティーエルオー
Tm	ティーエム
TM	ティーエム
TMC	ティーエムシー
TMD	ティーエムディー
TMI	ティーエムアイ
TMN	ティーエムエヌ
TNC	ティーエヌシー
TNPG	ティーエヌピージー
TNT	ティーエヌティー
to	ツー
To	ツー
TOA	ティーオーエイ
TOB	ティーオービー
ToBI	トビ
TODAY	トゥデー
TOEFL	トーフル
TOEIC	トーイック
TOKAI	トーカイ
tokei	トケイ
Tokina	トキナー
TOKIO	トキオ
TOKUJIROU	トクジロー
TOKUMITSU	トクミツ
Tokyo	トーキョー
TOKYO	トーキョー
TOM	ティーオーエム
Tomcat	トムキャット
tommy	トミー
Tommy	トミー
TOMOE	トモエ
Tomoko	トモコ
Tomorrow	トゥモロー
TOMS	ティーオーエムエス
TonSWU	トンエスダブリューユー
tonU	トンウラン
Ton‐U	トンウラン
tooth	トゥース
Tooth	トゥース
TOP	トップ
topic	トピック
TOPIC	トピック
TOPICS	トピックス
TOPIX	トピックス
TOR	ティーオーアール
TOSHIRO	トシロー
total	トータル
Total	トータル
TOTO	トートー
Totonacs	トトナカ
Tour	ツアー
TOUR	ツアー
TOV	ティーオーブイ
TOVS	ティーオーブイエス
TOWA	トーワ
Tower	タワー
TOWER	タワー
town	タウン
TOYOTA	トヨタ
TOZ	トーズ
TP	ティーピー
TPC	ティーピーシー
TPE	ティーピーイー
TPM	ティーピーエム
TPO	ティーピーオー
TPT	ティーピーティー
Tr	ティーアール
TR	ティーアール
trace	トレース
Trace	トレース
track	トラック
Trackpad	トラックパッド
trade	トレード
Trade	トレード
trades	トレーズ
Traffic	トラフィック
TRAFFIC	トラフィック
train	トレーン
Train	トレーン
TRAIN	トレーン
transfer	トランスファー
Transfer	トランスファー
Transit	トランジット
Transmeta	トランスメタ
Transport	トランスポート
TRANSSAC	ティーアールエーエヌエスエスエーシー
trash	トラッシュ
travellin’	トラベリング
treasure	トレジャー
Treaty	トリーティー
TREC	トレック
tree	ツリー
Tree	ツリー
TREE	ツリー
Treo	トレオ
TRIPs	ティーアールアイピーエス
TRIPS	ティーアールアイピーエス
ブリヂストンTRK	ブリジストンティーアールケイ
Troia	トロイア
Trombone	トロンボーン
TRON	トロン
Tropical	トロピカル
trouble	トラブル
TRS	ティーアールエス
TRU	ティーアールユー
TRUE	トゥルー
trust	トラスト
Trust	トラスト
truth	トゥルース
try	トライ
TRY	トライ
Ts	ティーエス
TS	ティーエス
TSC	ティーエスシー
TSH	ティーエスエイチ
TSL	ティーエスエル
T−SQUARE	ティースクエア
TSS	ティーエスエス
Tsunomegawa	ツノメガワ
TSUTAYA	ツタヤ
tSWU	トンエスダブリューユー
TTC	ティーティーシー
TTE	ティーティーイー
TTL	ティーティーエル
TTP	ティーティーピー
TTS	ティーティーエス
tu	チュ
tU	トンウラン
TU	ティーユー
TUBE	チューブ
Tumblr	タンブラー
TUMLINTON	トゥミルトン
Tune	チューン
Tunes	チューンズ
TUR	ティーユーアール
turn	ターン
Turner	ターナー
TURP	ティーユーアールピー
tv	ティーブイ
TV	テレビ
TVA	ティーブイエー
TVD	ティーブイディー
TVh	ティーブイエイチ
TVH	ティーブイエイチ
TVQ	ティーブイキュー
TVR	ティーブイアール
TWA	ティーダブリューエー
TWEBS	ティーダブリューイービーエス
Twitter	ツイッター
two	ツー
TWT	ティーダブリューティー
txt	ティーエックスティー
TXT	ティーエックスティー
TYK	ティーワイケイ
type	タイプ
Type	タイプ
TYS	ティーワイエス
U.S.A.	ユーエスエー
U19	ユーイチキュー
UA	ウーア
UAE	ユーエイイー
UAL	ユーエーエル
UAV	ユーエーブイ
UB	ユービー
UB40	ユービーフォーティ
UC	ユーシー
UCC	ユーシーシー
UCE	ユーシーイー
uchida	ウチダ
UCI	ユーシーアイ
UCL	ユーシーエル
UDEAC	ユーディーイーエーシー
UDF	ユーディーエフ
UEFA	ユーイーエフエー
Uehara	ウエハラ
UENO	ウエノ
UF6	ユーエフシックス
UFJ	ユーエフジェー
UFO	ユーフォー
UGTT	ユージーティーティー
UH	ユーエイチ
UH60ブラックホーク	ユーエイチロクジューブラックホーク
UHB	ユーエイチビー
UHF	ユーエイチエフ
UHI	ユーエイチアイ
UHT	ユーエイチティー
UI	ユーアイ
UICN	ユーアイシーエヌ
UIP映画	ユーアイピーエーガ
UIS	ユーアイエス
UJLI	ユージェーエルアイ
UJNR	ユージェーエヌアール
UJPP	ユージェーピーピー
UK	ユーケイ
UKAEA	ユーケーエーイーエー
ULSI	ユーエルエスアイ
Ultra	ウルトラ
UMAT	ユーエムエイティー
UN	ユーエヌ
UNAIDS	ユーエヌエーアイディーエス
UNAMIC	ユーエヌエーエムアイシー
UNAVEM	ユーエヌエーブイイーエム
UNCED	ユーエヌシーイーディー
UNCHS	ユーエヌシーエイチエス
UNCITRAL	ユーエヌシーアイティーアールエーエル
UNCRO	ユーエヌシーアールオー
UNCSTD	ユーエヌシーエスティーディー
UNCTAD	アンクタッド
UNDC	ユーエヌディーシー
Under	アンダー
UNDOF	アンドフ
UNDP	ユーエヌディーピー
UNDRO	ユーエヌディーアールオー
UNEF	ユネフ
UNEP	ユーエヌイーピー
UNEPTA	ユーエヌイーピーティーエー
UNESCO	ユネスコ
UNF	ユーエヌエフ
UNFPA	ユーエヌエフピーエー
UNGASS	ユーエヌジーエーエスエス
UNGOMAP	ユーエヌジーオーエムエーピー
UNHCR	ユーエヌエイチシーアール
UNICEF	ユニセフ
Unicode	ユニコード
unidic	ユニディック
UniDic	ユニディック
UNIDO	ユニード
UNIFICYP	ユーエヌアイエフアイシーワイピー
UNIFIL	ユーエヌアイエフアイエル
UNIFLL	ユーエヌアイエフエルエル
Uniform	ユニホーム
UNIIMOG	ユーエヌアイアイエムオージー
UNIKOM	ユニコム
Union	ユニオン
UNISIST	ユニシスト
UNISPACE	ユニスペース
UNISTST	ユーエヌアイエスティーエスティー
UNITA	ユーエヌアイティーエー
UNITAR	ユーエヌアイティーエーアール
United	ユナイテッド
Uniting	ユナイティング
University	ユニバーシティー
UNIX	ユニックス
UNL	ユーエヌエル
UNMEE	ユーエヌエムイーイー
UNMISET	ユーエヌエムアイエスイーティー
UNMOVIC	ユーエヌエムオーブイアイシー
UNOSOM	ユーエヌオーエスオーエム
UNPREDEP	ユーエヌピーアールイーディーイーピー
UNPROFOR	ユーエヌピーアールオーエフオーアール
UNREO	ユーエヌアールイーオー
UNRWA	アンルワ
UNSCEAR	ユーエヌエスシーイーエーアール
UNSF	ユーエヌエスエフ
UN‐SMA	ユーエヌエスエムエー
Unsolicited	アンソリシティッド
UNTAC	アンタック
UNTAES	ユーエヌティーエーイーエス
UNTAET	ユーエヌティーエーイーティー
UNTAG	ユーエヌティーエージー
UNU	ユーエヌユー
UO2	ユーオーツー
up	アップ
UP	アップ
update	アップデート
UPI	ユーピーアイ
Upjohn	アップジョン
UPN	ユーピーエヌ
UPOV	ウポブ
UPPER	アッパー
UPRONA	ユーピーアールオーエヌエー
UPS	ユーピーエス
UPU	ユーピーユー
UR	ユーアール
Urban	アーバン
URC	ユーアールシー
UrEDAS	ユレダス
URL	ユーアールエル
URSI	ユーアールエスアイ
US	ユーエス
USA	ユーエスエー
USAID	ユーエスエーアイディー
USB	ユーエスビー
USC	ユーエスシー
USDA	ユーエスディーエー
USEN	ユーセン
User	ユーザー
users	ユーザーズ
USERS	ユーエスイーアールエス
Ushin	ウーシン
USIJI	ユーエスアイジェーアイ
USJ	ユーエスジェー
USM	ユーエスエム
USOC	ユーエスオーシー
USPTO	ユーエスピーティーオー
USRSA	ユーエスアールエスエー
USSBS	ユーエスエスビーエス
USTR	ユーエスティーアール
Utility	ユーティリティー
UTMS	ユーティーエムエス
Utterance	アタランス
UTU	ウツ
UV	ユーブイ
UWP	ユーダブリューピー
UX	ユーエックス
v	ゴ
V	ゴ
V/m	ボルトマイメートル
V2	ブイニ
VACAS	バッカス
VAF	バフ
VAIO	バイオ
VAL	バル
Value	バリュー
Van	バン
VAN	ブイエーエヌ
VAR	ブイエーアール
VASIS	ブイエーエスアイエス
VBL	ブイビーエル
VC	ブイシー
VDT	ブイディーティー
vector	ベクター
vegetarian	ベジタリアン
VEGF	ブイイージーエフ
VENAUM	ブイイーエヌエーユーエム
VENOM	ベノム
Venus	ビーナス
VEP	ブイイーピー
Verio	ベリオ
Verizon	ベライゾン
Verlaine	ベルレーヌ
verse	バース
version	バージョン
Version	バージョン
Verteporfin	ベータポルフィン
Very	ベリー
VERY	ベリー
VF	ブイエフ
VFR	ブイエフアール
VFS	ブイエフエス
VGRS	ブイジーアールエス
VHF	ブイエイチエフ
VHS	ブイエイチエス
vi	ロク
VI	ロク
VIBE	バイブ
VICS	ビックス
Video	ビデオ
VIDEO	ビデオ
VIDEOTEX	ビデオテックス
VIERA	ビエラ
Viet Nam	ベトナム
view	ビュー
View	ビュー
VIEW	ビュー
Views	ビューズ
VIGOR	ビガ
vii	ナナ
VII	ナナ
viii	ハチ
VIII	ハチ
Viktor	ビクトール
VINUM	ビノム
VIOLON	ビオロン
VIP	ビップ
Virex	ブイアイアールイーエックス
VIREX	ブイアイアールイーエックス
VIRGO	バーゴ
Virtual	バーチャル
virus	ウイルス
Virus	ウイルス
Visa	ビザ
VISA	ビサ
Visio	ビジオ
Vista	ビスタ
VISTA	ビスタ
Visual	ビジュアル
Visual C++	ヴィジュアルシープラスプラス
Visudyne	ビスダイン
Vitality	バイタリティー
Vivace	ビバーチェ
VIVIER	ビビエ
VIVO	ビボ
VLBI	ブイエルビーアイ
VLCC	ブイエルシーシー
VLCT	ブイエルシーティー
VLDL	ブイエルディーエル
VLSI	ブイエルエスアイ
vo	ブイオー
Vo	ブイオー
VOC	ブイオーシー
vocaloid	ボーカロイド
Vocaloid	ボーカロイド
VOCALOID	ボーカロイド
VOCAROID	ヴォーカロイド
Vocational	ボケーショナル
VOD	ブイオーディー
vodafone	ボーダフォン
VODAS	ボーダス
voice	ボイス
Voice	ボイス
VOICE	ボイス
voiceroid	ボイスロイド
Voiceroid	ボイスロイド
VOICEROID	ボイスロイド
VoIP	ブイオーアイピー
Voizi	ボイジー
Vol	ボリューム
vol.	ボリューム
Vol.	ボリューム
Volume	ボリューム
Voluntary	ボランタリー
VON	フォン
VOR	ブイオーアール
VORTAC	ブイオーアールティーエーシー
VOU	ブイオーユー
VPI	ブイピーアイ
VPN	ブイピーエヌ
VQ	ブイキュー
VR	ブイアール
VRML	バーマル
VRS	ブイアールエス
vs	ブイエス
Vs	ブイエス
VS	バーサス
vs.	ブイエス
VSB	ブイエスビー
VSC	ブイエスシー
VSM	ブイエスエム
VSQ	ヴイエスキュー
VTOL	ブイトール
VTR	ブイティーアール
Vue	ビュー
VVER	ブイブイイーアール
VVVF	ブイブイブイエフ
VW	フォルクスワーゲン
VX	ブイエックス
w	ワット
W	ワット
W/m2	ワットマイヘーホーメートル
WA風	ワフー
WAC	ダブリューエーシー
WADA	ワダ
Wagner	ワーグナー
WAIS	ウェース
WAK	ダブリューエーケー
Wake	ウェーク
Wallace	ウォレス
WAM	ワム
WAN	ワン
WANDS	ワンズ
WANO	ワノ
War	ウォー
WAR	ウォー
WARC	ダブリューエーアールシー
Warehouse	ウェアハウス
Warning	ウォーニング
Washington	ワシントン
WASP	ワスプ
WASSAC	ダブリューエーエスエスエーシー
Wassenaar	ワッセナー
watch	ウォッチ
Watch	ウォッチ
water	ウォーター
Water	ウォーター
Watson	ワトソン
Watteau	バトー
WAV	ワヴ
WAV2	ワヴツー
Wave	ウエーブ
WAVE	ウエーブ
way	ウエー
Way	ウエー
Wb	ウェーバー
WB	ダブリュービー
Wb/m2	ウェーバーマイヘーホーメートル
WBA	ダブリュービーエイ
WBC	ダブリュービーシー
WBCSD	ダブリュービーシーエスディー
WBO	ダブリュービーオー
WBT	ダブリュービーティー
WBU	ダブリュービーユー
WC	ダブリューシー
WC.	ダブリューシー
WD	ダブリューディー
Weaknesses	ウィークネス
Weapons	ウェポンズ
web	ウェブ
Web	ウェブ
WEB	ウェブ
Weber	ウェーバー
WEC	ダブリューイーシー
WECPNL	ダブリューイーシーピーエヌエル
WEEE	ダブリューイーイーイー
week	ウイーク
Week	ウィーク
WEEK	ウイーク
WEEKLY	ウイークリー
well	ウェル
Well	ウェル
WEP	ダブリューイーピー
were	ワー
West	ウエスト
WEST	ウエスト
Westinghouse	ウェスチングハウス
WESTPAC	ダブリューイーエスティーピーエーシー
WEU	ダブリューイーユー
WF	ダブリューエフ
WFCL	ダブリューエフシーエル
WFD	ダブリューエフディー
WFP	ダブリューエフピー
WG	ダブリュージー
WH	ダブリューエイチ
what	ホワット
What	ホワット
What’s	ホワッツ
while	ホワイル
Whisky	ウイスキー
WHISKY	ウイスキー
white	ホワイト
White	ホワイト
who	フー
Who	フー
WHO	ダブリューエイチオー
whom	フーム
Whorf	ウォーフ
WHO’S	フーズ
why	ホワイ
WID	ウィッド
WIDESPREAD	ダブリューアイディーイーエスピーアールイーエーディー
WIDIAS	ウイディアス
Wierzbicka	ウィアズビッカ
WiFi	ワイファイ
Wii	ウィー
wiki	ウィキ
Wikipedia	ウィキペディア
wild	ワイルド
will	ウイル
WILL	ウイル
WILLCOM	ウィルコム
William	ウィリアム
WILLIAM	ウィリアム
Wilson	ウィルソン
win	ウィン
Win	ウィン
WIN	ウィン
windows	ウィンドーズ
Windows	ウィンドーズ
WINDOWS	ウィンドーズ
WINDS	ダブリューアイエヌディーエス
wine	ワイン
Wink	ウインク
Winny	ウィニー
WIPO	ワイポ
Wire	ワイヤ
WIRE	ワイヤ
Wireless	ワイヤレス
Wirgman	ワーグマン
WISP	ダブリューアイエスピー
with	ウィズ
WITH	ウィズ
witness	ウィットネス
WLR	ダブリューエルアール
WMA	ダブリューエムエー
WMD	ダブリューエムディー
WMO	ダブリューエムオー
Wnn	ウンヌ
WOC	ウオック
Wolff	ボルフ
woman	ウーマン
Woman	ウーマン
Women	ウィメン
WOMEN	ウィメン
wonderful	ワンダフル
Wonderful	ワンダフル
wood	ウッド
word	ワード
Word	ワード
WORD	ワード
WordPress	ワードプレス
work	ワーク
worker	ワーカー
Worker	ワーカー
Working	ワーキング
Works	ワークス
world	ワールド
World	ワールド
WORLD	ワールド
WORST	ワースト
Wotton	ウォットン
would	ウッド
WOWOW	ワウワウ
WOWWOW	ワウワウ
WP	ダブリューピー
WPC	ダブリューピーシー
WPI	ダブリューピーアイ
WPO	ダブリューピーオー
WPRO	ダブリューピーアールオー
WR	ダブリューアール
WRC	ダブリューアールシー
write	ライト
Writer	ライター
WS	ダブリューエス
WSSD	ダブリューエスエスディー
WSTS	ダブリューエスティーエス
WTCC	ダブリューティーシーシー
WTDC	ダブリューティーディーシー
WTI	ダブリューティーアイ
WTO	ダブリューティーオー
WTSC	ダブリューティーエスシー
WWF	ダブリューダブリューエフ
WWP	ダブリューダブリューピー
www	ダブリューダブリューダブリュー
WWW	ダブリューダブリューダブリュー
x	ジュー
X	テン
Xbox	エックスボックス
Xbox One	エックスボックスワン
XD	エックスディー
xDSL	エックスディーエスエル
XFV	エックスエフブイ
XHPSG	エックスエイチピーエスジー
XIAi	エックスアイエーアイ
Xmas	クリスマス
xml	エックスエムエル
XML	エックスエムエル
XNA	エックスエヌエー
XO	エックスオー
XOXO	キスキス
xp	エックスピー
XP	エックスピー
Xperia	エクスペリア
XR	エックスアール
XSL	エックスエスエル
XT	エックスティー
xyzzy	エックスワイゼットゼットワイ
Y子	ワイコ
YAB	ワイエイビー
YAG	ヤグ
YAGUDIN	ヤグディン
yahoo	ヤフー
Yahoo	ヤフー
YAHOO	ヤフー
yahoo!	ヤフー
Yahoo!	ヤフー
YAK	ワイエーケー
Yamada	ヤマダ
YAMADA	ヤマダ
yamaha	ヤマハ
Yamaha	ヤマハ
YAMAHA	ヤマハ
Yamakawa	ヤマカワ
Yamamoto	ヤマモト
Yamauchi	ヤマウチ
Yasufumi	ヤスフミ
Yasuhiro	ヤスヒロ
ybb	ワイビービー
YDKシステムセンター	ワイディーケイシステムセンター
YDT	ワイディーティー
year	イヤー
Year	イヤー
yearly	イヤリー
Yes	イエス
YFU	ワイエフユー
YIS	ワイアイエス
YITS	ワイアイティーエス
YKK	ワイケイケイ
河北YKKAP工業	カホクワイケーケーエーピーコーギョー
YKT	ワイケイティー
YMCA	ワイエムシーエー
YMO	ワイエムオー
YNAS	ワイエヌエーエス
YOG	ヨグ
YOGURT	ヨーグルト
YOKO	ヨーコ
Yokohama	ヨコハマ
YOKOHAMA	ヨコハマ
YONDA	ヨンダ
Yonda?	ヨンダ
Yoris	ユーリス
YOSAKOI	ヨサコイ
YOSHIE	ヨシエ
Yoshihisa	ヨシヒサ
Yoshimi	ヨシミ
Yoshizumi	ヨシズミ
you	ユー
You	ユー
YOU	ユー
your	ユア
Your	ユア
youth	ユース
Youth	ユース
youthful	ユースフル
YouTube	ユーチューブ
YouTuber	ユーチューバー
YP	ワイピー
YS	ワイエス
YTC	ワイティーシー
YTL	ワイティーエル
YTV	ワイティーブイ
YU	ユー
YUASA	ユアサ
Yuduki	ユズキ
Yuichi	ユーイチ
Yumiko	ユミコ
YWCA	ワイダブリューシーエイ
Z旗	ゼットキ
ZANLA	ゼットエーエヌエルエー
ZANU	ゼットエーエヌユー
Zapoteca	サポテカ
ZAPU	ゼットエーピーユー
ZARA	ザラ
ZARD	ザード
ZEALOT	ゼロット
Zeiss	ツァイス
ZEN	ゼン
ZERO	ゼロ
ZIBET	ジベット
zip	ジップ
Zip	ジップ
ZIP	ジップ
ZIPRA	ゼットアイピーアールエー
Zivilgesellschaft	ツィビルゲゼルシャフト
Zn	ゼットエヌ
ZN	ゼットエヌ
zone	ゾーン
Zone	ゾーン
ZONE	ゾーン
Zoom	ズーム
ZTV	ゼットティービー
ZUIKO	ズイコー
